player_id,p_tackled,tklw,def_3rd,mid_3rd,att_3rd,d_tackled,challenges,challenge_tackles_pct,challenges_lost,blocks,blocked_shots,blocked_passes,intr,tkl_intr,clr,err
1,62,34,18,35,9,24,49,49.0,25,23,4,19,29,91,43,0
2,2,1,2,0,0,2,2,100.0,0,1,0,1,0,2,7,1
3,46,30,17,20,9,19,63,30.2,44,31,1,30,10,56,12,1
4,23,15,9,9,5,4,13,30.8,9,26,3,23,4,27,19,0
5,66,33,29,29,8,32,49,65.3,17,29,13,16,24,90,22,0
6,22,16,4,13,5,4,19,21.1,15,30,1,29,20,42,10,0
7,42,25,19,14,9,17,35,48.6,18,18,3,15,9,51,34,1
8,46,33,31,12,3,26,40,65.0,14,25,11,14,23,69,48,1
9,48,22,23,15,10,20,53,37.7,33,27,11,16,13,61,55,0
10,22,13,16,6,0,11,14,78.6,3,20,13,7,32,54,77,1
11,34,21,21,11,2,20,24,83.3,4,25,15,10,32,66,44,1
12,22,13,9,11,2,9,23,39.1,14,15,6,9,12,34,33,1
13,18,13,13,4,1,8,15,53.3,7,22,10,12,24,42,51,0
14,29,21,20,9,0,15,22,68.2,7,20,8,12,16,45,52,0
15,14,6,10,3,1,6,9,66.7,3,10,7,3,5,19,23,0
16,10,6,3,7,0,4,8,50.0,4,9,3,6,5,15,19,0
17,7,2,3,4,0,2,11,18.2,9,9,3,6,11,18,8,0
18,7,6,0,5,2,1,4,25.0,3,4,1,3,1,8,3,0
19,10,4,3,5,2,4,7,57.1,3,8,1,7,5,15,5,0
20,0,0,0,0,0,0,0,0.0,0,0,0,0,0,0,1,0
21,4,2,0,4,0,1,3,33.3,2,5,1,4,3,7,4,0
22,4,3,2,2,0,3,5,60.0,2,6,1,5,1,5,2,0
23,1,1,0,0,1,1,2,50.0,1,1,0,1,0,1,4,0
24,1,1,0,1,0,1,3,33.3,2,1,0,1,1,2,0,0
25,0,0,0,0,0,0,0,0.0,0,0,0,0,0,0,0,0
26,0,0,0,0,0,0,1,0.0,1,0,0,0,0,0,0,0
27,0,0,0,0,0,0,0,0.0,0,0,0,0,0,0,0,0
28,46,25,10,31,5,21,43,48.8,22,26,8,18,18,64,26,0
29,35,26,14,11,10,17,30,56.7,13,20,1,19,10,45,10,1
30,30,17,19,11,0,11,22,50.0,11,33,13,20,23,53,42,1
31,1,0,1,0,0,1,1,100.0,0,1,0,1,1,2,4,3
32,16,10,3,8,5,8,13,61.5,5,15,1,14,9,25,19,0
33,17,11,6,6,5,2,14,14.3,12,14,3,11,6,23,22,0
34,70,38,38,25,7,44,72,61.1,28,26,7,19,24,94,49,1
35,28,18,7,14,7,15,27,55.6,12,24,12,12,9,37,10,1
36,42,24,29,10,3,18,29,62.1,11,34,23,11,26,68,75,1
37,43,21,26,12,5,26,48,54.2,22,16,9,7,20,63,25,1
38,34,17,15,17,2,12,25,48.0,13,23,13,10,13,47,55,0
39,34,17,17,13,4,13,35,37.1,22,22,8,14,20,54,15,1
40,29,20,15,13,1,18,24,75.0,6,11,6,5,10,39,48,0
41,24,15,11,11,2,14,22,63.6,8,22,16,6,14,38,46,2
42,25,14,15,6,4,8,15,53.3,7,18,4,14,10,35,16,1
43,29,19,11,16,2,11,22,50.0,11,12,4,8,12,41,9,2
44,18,7,11,5,2,9,17,52.9,8,3,1,2,6,24,3,0
45,6,4,0,3,3,4,6,66.7,2,3,0,3,1,7,9,0
46,10,8,3,6,1,4,9,44.4,5,7,3,4,11,21,14,0
47,0,0,0,0,0,0,0,0.0,0,0,0,0,0,0,2,0
48,6,4,1,4,1,3,10,30.0,7,8,1,7,0,6,10,0
49,5,1,2,3,0,1,2,50.0,1,4,3,1,1,6,12,1
50,16,9,11,5,0,6,13,46.2,7,10,2,8,6,22,7,0
51,0,0,0,0,0,0,0,0.0,0,0,0,0,0,0,1,0
52,2,2,1,1,0,1,3,33.3,2,3,0,3,0,2,1,0
53,1,1,1,0,0,0,0,0.0,0,5,4,1,0,1,3,0
54,0,0,0,0,0,0,3,0.0,3,2,0,2,0,0,0,0
55,2,0,1,1,0,2,4,50.0,2,1,1,0,0,2,7,0
56,2,1,2,0,0,2,5,40.0,3,0,0,0,0,2,4,0
57,1,1,0,0,1,0,2,0.0,2,1,1,0,1,2,2,0
58,1,1,1,0,0,1,1,100.0,0,1,1,0,1,2,1,0
59,1,1,1,0,0,0,0,0.0,0,1,0,1,0,1,1,0
60,2,1,2,0,0,1,2,50.0,1,1,1,0,0,2,0,0
61,0,0,0,0,0,0,2,0.0,2,0,0,0,0,0,0,0
62,0,0,0,0,0,0,0,0.0,0,0,0,0,0,0,0,0
63,58,42,32,21,5,21,29,72.4,8,45,27,18,40,98,147,0
64,0,0,0,0,0,0,0,0.0,0,0,0,0,1,1,11,2
65,69,43,24,35,10,31,58,53.4,27,43,17,26,25,94,65,0
66,58,39,22,30,6,30,45,66.7,15,26,6,20,25,83,34,0
67,33,19,16,16,1,19,24,79.2,5,26,15,11,19,52,90,1
68,48,29,31,11,6,17,27,63.0,10,28,7,21,18,66,69,0
69,47,30,23,15,9,25,43,58.1,18,28,3,25,11,58,26,1
70,60,36,38,18,4,32,48,66.7,16,34,15,19,37,97,94,0
71,9,5,0,6,3,4,11,36.4,7,4,2,2,1,10,11,0
72,37,23,20,13,4,17,33,51.5,16,29,8,21,9,46,43,0
73,20,10,7,6,7,3,13,23.1,10,17,1,16,6,26,4,0
74,18,14,6,8,4,10,26,38.5,16,10,1,9,7,25,6,0
75,11,9,7,3,1,4,5,80.0,1,11,4,7,9,20,42,0
76,27,20,16,8,3,15,20,75.0,5,12,1,11,5,32,15,0
77,13,9,5,6,2,4,8,50.0,4,6,0,6,1,14,4,0
78,13,7,7,6,0,4,5,80.0,1,13,7,6,15,28,23,0
79,7,4,3,2,2,1,3,33.3,2,4,1,3,2,9,5,0
80,9,5,2,5,2,3,5,60.0,2,7,1,6,5,14,3,0
81,23,13,9,11,3,11,18,61.1,7,17,5,12,6,29,19,0
82,5,3,1,3,1,3,7,42.9,4,3,0,3,4,9,1,0
83,6,6,0,6,0,5,10,50.0,5,5,2,3,5,11,4,0
84,5,2,1,3,1,4,6,66.7,2,5,1,4,0,5,2,0
85,0,0,0,0,0,0,0,0.0,0,0,0,0,0,0,1,0
86,0,0,0,0,0,0,0,0.0,0,1,0,1,1,1,2,0
87,1,1,0,1,0,1,1,100.0,0,0,0,0,1,2,1,0
88,0,0,0,0,0,0,0,0.0,0,0,0,0,0,0,0,0
89,0,0,0,0,0,0,0,0.0,0,0,0,0,0,0,1,0
90,0,0,0,0,0,0,0,0.0,0,1,0,1,0,0,1,0
91,0,0,0,0,0,0,0,0.0,0,0,0,0,0,0,1,0
92,0,0,0,0,0,0,0,0.0,0,0,0,0,0,0,0,0
93,0,0,0,0,0,0,0,0.0,0,0,0,0,0,0,0,0
94,42,24,29,12,1,19,31,61.3,12,53,33,20,57,99,99,0
95,80,46,37,36,7,43,62,69.4,19,47,8,39,40,120,33,1
96,52,32,29,18,5,19,39,48.7,20,43,17,26,57,109,70,0
97,80,43,36,32,12,35,82,42.7,47,36,10,26,40,120,54,0
98,39,24,12,22,5,17,50,34.0,33,33,3,30,10,49,34,0
99,27,14,13,7,7,14,28,50.0,14,42,3,39,22,49,42,0
100,0,0,0,0,0,0,0,0.0,0,0,0,0,0,0,20,3
101,44,32,23,19,2,30,49,61.2,19,22,9,13,21,65,47,0
102,31,20,3,12,16,8,18,44.4,10,29,2,27,7,38,6,0
103,30,20,15,10,5,16,34,47.1,18,29,4,25,5,35,19,0
104,28,17,9,18,1,14,31,45.2,17,28,6,22,16,44,34,0
105,18,13,2,9,7,8,22,36.4,14,18,0,18,9,27,0,1
106,15,9,4,5,6,7,14,50.0,7,7,1,6,4,19,8,0
107,12,6,6,4,2,5,13,38.5,8,6,1,5,2,14,5,1
108,1,0,1,0,0,1,1,100.0,0,0,0,0,0,1,6,0
109,26,17,17,7,2,15,35,42.9,20,24,3,21,7,33,25,0
110,12,5,8,2,2,5,15,33.3,10,21,7,14,4,16,21,0
111,19,8,6,8,5,13,26,50.0,13,8,4,4,13,32,27,0
112,18,12,8,10,0,7,14,50.0,7,11,5,6,11,29,29,0
113,7,3,6,1,0,2,12,16.7,10,5,0,5,3,10,6,0
114,1,1,0,1,0,0,1,0.0,1,0,0,0,1,2,2,0
115,3,2,0,2,1,1,1,100.0,0,4,0,4,1,4,0,0
116,0,0,0,0,0,0,1,0.0,1,0,0,0,0,0,1,0
117,4,2,2,2,0,2,3,66.7,1,1,1,0,1,5,1,0
118,5,4,3,1,1,1,4,25.0,3,2,0,2,1,6,3,0
119,4,3,0,3,1,1,1,100.0,0,0,0,0,0,4,2,1
120,2,1,1,1,0,1,1,100.0,0,2,1,1,1,3,6,0
121,0,0,0,0,0,0,0,0.0,0,0,0,0,0,0,0,0
122,0,0,0,0,0,0,0,0.0,0,0,0,0,0,0,0,0
123,2,2,2,0,0,2,3,66.7,1,0,0,0,1,3,11,3
124,32,20,8,15,9,13,24,54.2,11,25,2,23,3,35,36,0
125,37,21,16,17,4,16,37,43.2,21,25,8,17,17,54,27,1
126,78,50,41,32,5,38,69,55.1,31,37,9,28,36,114,53,2
127,27,11,14,11,2,16,25,64.0,9,35,21,14,15,42,99,2
128,77,46,35,38,4,49,88,55.7,39,27,8,19,18,95,72,0
129,47,32,28,16,3,22,32,68.8,10,38,13,25,50,97,74,3
130,52,34,23,22,7,20,35,57.1,15,35,8,27,12,64,45,1
131,35,20,9,20,6,15,34,44.1,19,28,6,22,12,47,22,0
132,48,29,31,17,0,27,36,75.0,9,32,17,15,16,64,68,2
133,32,22,13,14,5,12,27,44.4,15,13,1,12,13,45,10,1
134,30,15,17,11,2,17,39,43.6,22,20,1,19,10,40,14,0
135,23,14,13,4,6,9,30,30.0,21,25,3,22,8,31,19,1
136,17,10,9,7,1,7,12,58.3,5,5,2,3,7,24,11,0
137,10,6,5,4,1,5,10,50.0,5,15,5,10,5,15,30,0
138,21,16,8,12,1,8,15,53.3,7,14,1,13,7,28,10,0
139,16,10,5,10,1,6,13,46.2,7,15,1,14,4,20,14,0
140,10,8,5,2,3,4,7,57.1,3,9,4,5,6,16,27,0
141,0,0,0,0,0,0,0,0.0,0,0,0,0,0,0,2,0
142,12,7,4,5,3,7,14,50.0,7,8,2,6,6,18,12,0
143,4,4,1,1,2,1,3,33.3,2,9,0,9,1,5,3,0
144,3,3,2,1,0,2,8,25.0,6,4,0,4,4,7,1,0
145,2,1,0,1,1,1,3,33.3,2,1,0,1,1,3,1,0
146,3,0,0,2,1,1,2,50.0,1,1,1,0,1,4,4,0
147,10,4,9,1,0,4,9,44.4,5,2,0,2,5,15,3,0
148,1,0,1,0,0,0,2,0.0,2,3,0,3,0,1,2,0
149,4,0,0,4,0,1,2,50.0,1,0,0,0,0,4,7,1
150,0,0,0,0,0,0,0,0.0,0,0,0,0,0,0,0,0
151,72,41,33,28,11,28,50,56.0,22,36,6,30,25,97,55,2
152,34,20,21,11,2,11,27,40.7,16,38,26,12,36,70,77,1
153,57,36,30,22,5,33,77,42.9,44,26,7,19,29,86,43,1
154,6,5,1,2,3,2,4,50.0,2,7,1,6,0,6,19,1
155,31,19,20,10,1,11,24,45.8,13,40,27,13,22,53,79,0
156,32,18,12,19,1,12,20,60.0,8,30,16,14,16,48,75,0
157,22,13,3,10,9,2,18,11.1,16,12,0,12,3,25,6,1
158,0,0,0,0,0,0,1,0.0,1,1,0,1,0,0,3,1
159,35,20,14,16,5,17,51,33.3,34,28,5,23,20,55,22,0
160,36,19,25,8,3,28,50,56.0,22,27,7,20,8,44,50,0
161,21,13,14,4,3,6,15,40.0,9,11,4,7,13,34,15,2
162,60,31,16,31,13,27,46,58.7,19,21,1,20,11,71,11,1
163,0,0,0,0,0,0,0,0.0,0,0,0,0,0,0,2,1
164,15,7,10,5,0,8,18,44.4,10,8,2,6,3,18,15,0
165,25,18,11,8,6,16,24,66.7,8,13,4,9,9,34,16,0
166,21,11,12,6,3,11,19,57.9,8,11,5,6,12,33,37,1
167,20,14,10,9,1,8,22,36.4,14,12,4,8,9,29,17,0
168,16,11,4,10,2,3,12,25.0,9,5,0,5,4,20,2,1
169,8,4,2,3,3,3,6,50.0,3,7,0,7,2,10,3,0
170,23,16,10,10,3,14,25,56.0,11,12,5,7,8,31,25,0
171,9,5,3,4,2,1,1,100.0,0,2,0,2,0,9,4,0
172,10,5,5,5,0,1,4,25.0,3,7,4,3,4,14,26,2
173,1,1,1,0,0,1,4,25.0,3,6,5,1,5,6,8,0
174,8,5,2,5,1,4,8,50.0,4,4,1,3,3,11,6,1
175,3,1,0,1,2,0,0,0.0,0,1,0,1,0,3,4,0
176,2,1,1,1,0,2,3,66.7,1,2,0,2,0,2,1,0
177,2,2,1,1,0,0,6,0.0,6,3,2,1,0,2,2,0
178,0,0,0,0,0,0,0,0.0,0,0,0,0,0,0,0,0
179,0,0,0,0,0,0,0,0.0,0,0,0,0,0,0,0,0
180,0,0,0,0,0,0,0,0.0,0,0,0,0,0,0,0,0
181,45,31,24,19,2,27,49,55.1,22,27,7,20,29,74,63,2
182,78,45,32,33,13,34,90,37.8,56,45,3,42,27,105,23,0
183,1,0,1,0,0,1,3,33.3,2,0,0,0,0,1,12,1
184,35,20,16,12,7,15,53,28.3,38,34,4,30,7,42,13,0
185,34,15,11,18,5,21,49,42.9,28,24,6,18,21,55,24,1
186,25,18,14,11,0,16,24,66.7,8,29,17,12,29,54,115,0
187,27,16,11,15,1,9,21,42.9,12,26,2,24,21,48,15,0
188,32,14,23,8,1,19,34,55.9,15,27,14,13,20,52,69,0
189,11,9,2,5,4,3,14,21.4,11,9,3,6,5,16,11,0
190,26,18,13,10,3,18,28,64.3,10,20,4,16,12,38,37,1
191,13,8,10,3,0,8,18,44.4,10,15,9,6,6,19,44,0
192,53,36,22,22,9,28,52,53.8,24,24,5,19,18,71,7,0
193,22,10,1,12,9,6,20,30.0,14,22,2,20,2,24,18,0
194,15,9,13,2,0,6,15,40.0,9,19,16,3,12,27,61,0
195,46,28,25,17,4,16,36,44.4,20,27,6,21,23,69,29,0
196,24,12,7,16,1,8,18,44.4,10,15,7,8,17,41,19,1
197,4,3,2,1,1,1,9,11.1,8,11,1,10,4,8,4,0
198,24,14,8,13,3,15,24,62.5,9,16,6,10,17,41,31,0
199,32,17,12,20,0,20,31,64.5,11,17,5,12,12,44,21,0
200,18,13,7,10,1,9,17,52.9,8,7,3,4,9,27,20,0
201,0,0,0,0,0,0,1,0.0,1,0,0,0,1,1,3,1
202,16,12,5,7,4,3,12,25.0,9,16,2,14,3,19,1,0
203,1,1,1,0,0,1,3,33.3,2,1,0,1,0,1,8,0
204,41,21,24,14,3,22,36,61.1,14,22,14,8,27,68,95,1
205,26,13,6,10,10,9,21,42.9,12,16,1,15,14,40,10,0
206,46,28,20,23,3,28,50,56.0,22,28,4,24,14,60,39,0
207,68,45,38,26,4,34,48,70.8,14,37,14,23,28,96,65,4
208,45,30,17,24,4,26,42,61.9,16,27,3,24,18,63,8,0
209,34,21,12,15,7,15,33,45.5,18,26,5,21,10,44,12,0
210,12,9,9,1,2,8,13,61.5,5,24,11,13,28,40,63,0
211,50,29,24,15,11,32,45,71.1,13,24,12,12,17,67,45,2
212,28,18,15,8,5,8,26,30.8,18,22,1,21,12,40,7,0
213,26,14,4,17,5,11,20,55.0,9,28,3,25,2,28,11,0
214,22,11,7,9,6,10,17,58.8,7,12,0,12,2,24,8,0
215,26,11,8,13,5,10,22,45.5,12,14,3,11,9,35,18,1
216,30,15,11,12,7,15,26,57.7,11,21,5,16,17,47,26,0
217,11,8,1,4,6,6,7,85.7,1,10,1,9,0,11,22,0
218,10,5,5,1,4,3,8,37.5,5,12,0,12,2,12,2,0
219,10,2,6,4,0,4,8,50.0,4,16,0,16,2,12,10,0
220,7,3,1,4,2,4,9,44.4,5,8,1,7,1,8,3,0
221,6,2,1,3,2,3,7,42.9,4,5,0,5,2,8,3,0
222,8,6,6,2,0,2,11,18.2,9,7,0,7,1,9,0,0
223,5,3,1,4,0,2,5,40.0,3,2,0,2,5,10,11,0
224,18,9,5,10,3,6,12,50.0,6,3,1,2,2,20,6,0
225,9,4,5,2,2,5,11,45.5,6,3,1,2,5,14,14,0
226,0,0,0,0,0,0,0,0.0,0,0,0,0,0,0,1,0
227,1,0,0,1,0,1,6,16.7,5,2,0,2,2,3,2,0
228,1,1,0,1,0,0,1,0.0,1,3,0,3,1,2,1,0
229,1,1,1,0,0,1,2,50.0,1,0,0,0,0,1,2,0
230,1,1,1,0,0,1,1,100.0,0,1,0,1,1,2,2,0
231,0,0,0,0,0,0,0,0.0,0,0,0,0,0,0,0,0
232,1,0,1,0,0,1,1,100.0,0,0,0,0,1,2,14,4
233,36,26,15,17,4,18,31,58.1,13,21,4,17,15,51,36,3
234,18,7,9,2,7,3,12,25.0,9,20,6,14,7,25,26,0
235,45,26,21,22,2,28,45,62.2,17,22,9,13,24,69,64,2
236,28,16,6,14,8,4,30,13.3,26,26,7,19,11,39,16,0
237,70,39,43,24,3,24,34,70.6,10,20,12,8,69,139,131,0
238,33,18,17,12,4,15,23,65.2,8,21,3,18,27,60,25,0
239,35,16,13,18,4,18,37,48.6,19,24,11,13,47,82,25,2
240,22,8,9,10,3,13,27,48.1,14,20,7,13,20,42,31,0
241,18,15,5,9,4,4,9,44.4,5,7,1,6,6,24,12,0
242,18,11,7,9,2,13,19,68.4,6,14,1,13,8,26,29,0
243,30,21,9,20,1,9,29,31.0,20,24,8,16,23,53,27,1
244,17,8,7,6,4,11,16,68.8,5,12,2,10,13,30,28,0
245,17,12,8,8,1,5,20,25.0,15,12,6,6,11,28,30,0
246,20,12,11,8,1,3,9,33.3,6,10,2,8,9,29,23,0
247,14,9,9,5,0,3,4,75.0,1,10,5,5,10,24,20,0
248,5,1,1,4,0,1,5,20.0,4,4,1,3,2,7,3,0
249,10,7,5,5,0,4,5,80.0,1,9,5,4,13,23,10,0
250,5,3,1,4,0,3,4,75.0,1,1,0,1,1,6,0,0
251,11,7,3,8,0,4,7,57.1,3,10,4,6,4,15,9,1
252,1,1,0,0,1,1,3,33.3,2,3,0,3,0,1,0,0
253,3,1,1,1,1,0,3,0.0,3,2,0,2,1,4,0,0
254,9,7,4,5,0,3,3,100.0,0,8,5,3,3,12,22,0
255,0,0,0,0,0,0,1,0.0,1,0,0,0,0,0,1,1
256,2,2,1,1,0,2,6,33.3,4,2,0,2,0,2,3,1
257,1,0,0,0,1,0,0,0.0,0,0,0,0,0,1,1,0
258,1,1,1,0,0,0,0,0.0,0,0,0,0,3,4,7,0
259,1,1,0,1,0,1,3,33.3,2,0,0,0,0,1,1,0
260,0,0,0,0,0,0,0,0.0,0,1,1,0,1,1,0,0
261,0,0,0,0,0,0,0,0.0,0,0,0,0,0,0,0,0
262,61,39,18,30,13,24,60,40.0,36,30,8,22,30,91,29,0
263,58,36,26,26,6,32,68,47.1,36,43,16,27,24,82,45,0
264,61,33,21,29,11,34,69,49.3,35,40,5,35,28,89,19,1
265,42,21,11,19,12,15,49,30.6,34,15,1,14,13,55,9,0
266,1,0,1,0,0,1,2,50.0,1,0,0,0,0,1,10,1
267,19,8,8,7,4,11,34,32.4,23,9,1,8,15,34,11,1
268,33,27,17,14,2,16,32,50.0,16,24,10,14,20,53,90,0
269,42,19,28,12,2,23,33,69.7,10,23,12,11,23,65,67,1
270,23,15,6,13,4,12,24,50.0,12,12,1,11,9,32,15,0
271,9,5,0,4,5,2,4,50.0,2,5,1,4,2,11,18,0
272,24,12,13,10,1,6,11,54.5,5,18,12,6,16,40,65,0
273,50,29,29,15,6,23,39,59.0,16,35,6,29,20,70,25,0
274,21,10,6,10,5,6,15,40.0,9,15,1,14,3,24,7,0
275,27,15,17,5,5,14,21,66.7,7,17,2,15,15,42,19,0
276,36,24,13,17,6,20,37,54.1,17,20,3,17,4,40,15,0
277,14,10,10,3,1,5,10,50.0,5,12,9,3,8,22,32,0
278,12,4,1,3,8,3,12,25.0,9,11,0,11,1,13,7,0
279,1,1,1,0,0,1,1,100.0,0,0,0,0,1,2,2,0
280,4,2,2,0,2,1,6,16.7,5,3,0,3,2,6,1,1
281,5,2,1,2,2,2,3,66.7,1,5,1,4,1,6,13,0
282,4,3,1,3,0,2,2,100.0,0,2,0,2,2,6,8,0
283,8,3,2,3,3,4,8,50.0,4,3,0,3,2,10,6,0
284,5,3,1,4,0,2,2,100.0,0,2,0,2,0,5,2,0
285,4,1,0,4,0,2,4,50.0,2,5,2,3,1,5,4,0
286,5,2,1,3,1,2,7,28.6,5,1,0,1,0,5,0,0
287,1,1,0,1,0,0,1,0.0,1,0,0,0,0,1,0,0
288,1,1,1,0,0,0,0,0.0,0,0,0,0,1,2,1,0
289,0,0,0,0,0,0,0,0.0,0,1,1,0,0,0,0,0
290,0,0,0,0,0,0,0,0.0,0,0,0,0,0,0,1,0
291,0,0,0,0,0,0,0,0.0,0,0,0,0,1,1,21,3
292,133,72,47,70,16,55,91,60.4,36,55,14,41,51,184,42,1
293,23,10,8,10,5,12,44,27.3,32,15,2,13,11,34,13,0
294,51,33,38,11,2,32,50,64.0,18,50,26,24,45,96,113,0
295,51,27,23,24,4,24,61,39.3,37,45,13,32,50,101,54,1
296,50,24,28,19,3,15,46,32.6,31,27,6,21,23,73,35,0
297,26,10,18,7,1,11,22,50.0,11,51,31,20,22,48,116,1
298,44,25,26,13,5,21,31,67.7,10,30,10,20,21,65,78,0
299,17,9,7,8,2,6,20,30.0,14,18,2,16,0,17,30,0
300,16,11,9,6,1,8,9,88.9,1,18,12,6,21,37,87,3
301,35,20,18,11,6,17,41,41.5,24,22,8,14,5,40,16,0
302,21,10,7,10,4,9,22,40.9,13,12,4,8,9,30,15,0
303,34,19,13,18,3,15,31,48.4,16,20,6,14,7,41,22,0
304,23,15,14,8,1,12,15,80.0,3,16,10,6,30,53,40,1
305,26,20,19,5,2,8,19,42.1,11,9,1,8,5,31,22,0
306,8,4,2,4,2,5,9,55.6,4,11,3,8,1,9,7,0
307,19,11,9,8,2,7,14,50.0,7,21,5,16,4,23,20,0
308,16,10,12,4,0,8,10,80.0,2,20,5,15,8,24,28,0
309,7,6,3,2,2,5,8,62.5,3,3,0,3,6,13,11,1
310,2,2,1,0,1,1,2,50.0,1,2,0,2,0,2,2,0
311,0,0,0,0,0,0,0,0.0,0,0,0,0,0,0,0,0
312,0,0,0,0,0,0,3,0.0,3,1,0,1,0,0,1,0
313,6,1,2,3,1,4,7,57.1,3,2,0,2,0,6,1,0
314,5,4,4,1,0,3,3,100.0,0,1,0,1,3,8,5,0
315,1,1,1,0,0,1,1,100.0,0,6,3,3,2,3,4,0
316,3,3,1,2,0,1,3,33.3,2,0,0,0,2,5,5,0
317,6,4,5,1,0,3,6,50.0,3,3,0,3,4,10,5,0
318,1,0,0,1,0,0,1,0.0,1,1,0,1,0,1,0,0
319,1,1,0,1,0,0,0,0.0,0,1,0,1,0,1,3,0
320,0,0,0,0,0,0,0,0.0,0,0,0,0,0,0,0,0
321,0,0,0,0,0,0,1,0.0,1,1,1,0,1,1,0,0
322,0,0,0,0,0,0,0,0.0,0,1,0,1,0,0,0,0
323,0,0,0,0,0,0,0,0.0,0,0,0,0,0,0,0,0
324,0,0,0,0,0,0,1,0.0,1,0,0,0,0,0,0,0
325,44,25,20,20,4,23,49,46.9,26,29,11,18,27,71,46,1
326,25,15,6,13,6,11,20,55.0,9,11,4,7,14,39,14,0
327,1,0,1,0,0,1,4,25.0,3,1,0,1,1,2,10,2
328,41,25,34,7,0,22,34,64.7,12,40,25,15,37,78,115,1
329,61,30,27,25,9,31,50,62.0,19,30,11,19,31,92,38,0
330,13,7,2,5,6,8,17,47.1,9,4,1,3,2,15,18,0
331,25,14,19,4,2,13,22,59.1,9,26,17,9,29,54,53,0
332,28,19,16,7,5,14,25,56.0,11,30,11,19,18,46,48,0
333,19,10,16,3,0,11,24,45.8,13,18,1,17,13,32,28,0
334,27,17,17,9,1,16,27,59.3,11,20,16,4,27,54,49,1
335,30,18,13,13,4,13,21,61.9,8,20,5,15,9,39,28,0
336,57,34,34,20,3,28,41,68.3,13,22,13,9,14,71,31,0
337,38,22,24,12,2,20,31,64.5,11,23,13,10,17,55,56,1
338,17,12,3,9,5,8,14,57.1,6,18,5,13,0,17,14,0
339,29,22,16,10,3,13,17,76.5,4,13,3,10,6,35,13,0
340,5,5,0,5,0,2,4,50.0,2,6,2,4,0,5,27,0
341,25,15,10,12,3,8,26,30.8,18,12,1,11,7,32,4,0
342,19,13,14,4,1,9,17,52.9,8,15,2,13,4,23,18,0
343,20,11,14,4,2,3,9,33.3,6,10,4,6,12,32,15,0
344,18,10,13,2,3,4,13,30.8,9,16,3,13,3,21,5,0
345,0,0,0,0,0,0,0,0.0,0,0,0,0,0,0,0,0
346,2,1,1,1,0,0,1,0.0,1,0,0,0,2,4,0,0
347,6,4,2,3,1,2,3,66.7,1,2,0,2,1,7,1,0
348,3,2,0,2,1,3,6,50.0,3,2,0,2,2,5,1,0
349,6,1,1,4,1,2,4,50.0,2,5,2,3,0,6,6,0
350,4,0,2,1,1,0,2,0.0,2,4,0,4,2,6,3,0
351,0,0,0,0,0,0,2,0.0,2,0,0,0,1,1,0,0
352,0,0,0,0,0,0,0,0.0,0,0,0,0,0,0,1,1
353,1,1,1,0,0,1,1,100.0,0,1,1,0,0,1,0,0
354,1,1,1,0,0,0,0,0.0,0,0,0,0,0,1,0,0
355,0,0,0,0,0,0,0,0.0,0,0,0,0,0,0,0,0
356,1,1,1,0,0,1,3,33.3,2,0,0,0,0,1,25,2
357,50,28,21,22,7,23,57,40.4,34,45,12,33,17,67,44,2
358,59,39,17,35,7,31,52,59.6,21,29,12,17,26,85,21,0
359,33,18,23,10,0,15,25,60.0,10,50,28,22,45,78,118,0
360,53,30,33,18,2,17,29,58.6,12,17,9,8,24,77,114,1
361,42,30,11,22,9,15,47,31.9,32,15,0,15,6,48,8,0
362,26,16,11,6,9,16,31,51.6,15,10,1,9,6,32,14,0
363,39,26,25,12,2,23,48,47.9,25,17,7,10,23,62,49,2
364,51,39,24,23,4,22,45,48.9,23,29,7,22,20,71,25,1
365,36,22,25,9,2,20,33,60.6,13,26,9,17,27,63,89,1
366,36,27,19,14,3,18,29,62.1,11,30,9,21,26,62,55,2
367,14,9,5,3,6,5,14,35.7,9,7,1,6,4,18,10,0
368,18,8,5,7,6,6,16,37.5,10,17,2,15,2,20,14,0
369,30,19,23,6,1,17,31,54.8,14,24,6,18,20,50,17,0
370,1,0,0,0,1,0,3,0.0,3,0,0,0,1,2,13,0
371,24,13,9,13,2,8,11,72.7,3,8,3,5,7,31,24,0
372,16,9,9,7,0,13,17,76.5,4,12,3,9,4,20,17,1
373,4,1,1,3,0,1,8,12.5,7,9,1,8,3,7,3,0
374,17,10,10,7,0,10,19,52.6,9,12,5,7,7,24,33,1
375,14,8,10,4,0,5,10,50.0,5,14,2,12,10,24,18,0
376,13,10,5,6,2,7,10,70.0,3,9,5,4,6,19,21,0
377,11,3,9,2,0,4,5,80.0,1,4,2,2,9,20,19,2
378,4,4,1,2,1,4,7,57.1,3,4,1,3,1,5,0,0
379,6,3,0,5,1,2,5,40.0,3,6,1,5,0,6,4,0
380,7,3,1,3,3,2,3,66.7,1,6,4,2,1,8,8,0
381,6,5,1,4,1,3,7,42.9,4,3,0,3,3,9,9,0
382,3,1,2,0,1,1,7,14.3,6,4,0,4,0,3,2,0
383,0,0,0,0,0,0,0,0.0,0,0,0,0,0,0,5,0
384,4,2,1,1,2,3,4,75.0,1,6,3,3,1,5,4,0
385,2,2,0,0,2,0,0,0.0,0,1,0,1,1,3,0,0
386,1,1,0,1,0,1,1,100.0,0,0,0,0,1,2,0,0
387,0,0,0,0,0,0,0,0.0,0,0,0,0,0,0,0,0
388,0,0,0,0,0,0,1,0.0,1,0,0,0,0,0,1,0
389,0,0,0,0,0,0,0,0.0,0,0,0,0,1,1,0,0
390,0,0,0,0,0,0,0,0.0,0,0,0,0,0,0,0,0
391,0,0,0,0,0,0,0,0.0,0,0,0,0,0,0,0,0
392,0,0,0,0,0,0,0,0.0,0,1,0,1,1,1,21,2
393,21,12,16,5,0,8,15,53.3,7,42,26,16,23,44,144,1
394,43,30,22,20,1,19,25,76.0,6,37,26,11,51,94,130,1
395,55,33,35,16,4,30,46,65.2,16,40,11,29,35,90,99,0
396,68,41,32,29,7,37,96,38.5,59,54,13,41,44,112,44,0
397,43,27,31,11,1,31,49,63.3,18,34,9,25,25,68,67,0
398,17,6,3,9,5,6,10,60.0,4,12,4,8,4,21,22,0
399,45,29,16,22,7,23,51,45.1,28,21,2,19,14,59,10,0
400,26,14,12,12,2,12,19,63.2,7,13,1,12,20,46,22,0
401,43,22,22,17,4,22,34,64.7,12,16,5,11,9,52,45,2
402,27,23,11,12,4,7,21,33.3,14,18,0,18,3,30,7,0
403,44,31,13,27,4,13,30,43.3,17,27,1,26,11,55,13,0
404,33,19,11,19,3,15,43,34.9,28,16,2,14,22,55,39,0
405,39,23,15,16,8,17,34,50.0,17,22,4,18,12,51,13,0
406,31,18,16,12,3,17,28,60.7,11,20,3,17,5,36,9,0
407,24,17,8,7,9,14,20,70.0,6,17,0,17,7,31,11,0
408,10,6,3,5,2,1,4,25.0,3,17,1,16,4,14,16,0
409,11,6,6,2,3,5,16,31.3,11,7,1,6,4,15,5,2
410,6,4,5,1,0,6,10,60.0,4,4,3,1,5,11,14,0
411,6,4,3,3,0,3,4,75.0,1,4,3,1,7,13,20,0
412,3,1,3,0,0,0,2,0.0,2,2,2,0,1,4,0,0
413,8,8,2,5,1,2,8,25.0,6,5,0,5,1,9,0,0
414,1,0,0,1,0,0,0,0.0,0,0,0,0,0,1,0,0
415,1,0,0,1,0,1,1,100.0,0,0,0,0,0,1,0,0
416,0,0,0,0,0,0,0,0.0,0,0,0,0,0,0,0,0
417,0,0,0,0,0,0,0,0.0,0,0,0,0,0,0,0,0
418,66,43,40,26,0,36,77,46.8,41,43,6,37,43,109,66,1
419,72,48,42,28,2,39,48,81.3,9,53,26,27,45,117,158,1
420,19,11,4,11,4,5,20,25.0,15,18,3,15,3,22,36,1
421,40,19,18,18,4,16,39,41.0,23,26,6,20,10,50,25,0
422,45,32,26,13,6,25,38,65.8,13,29,2,27,26,71,66,0
423,35,24,25,10,0,21,33,63.6,12,29,20,9,29,64,118,0
424,43,27,34,9,0,22,35,62.9,13,36,21,15,23,66,140,1
425,19,9,11,5,3,11,29,37.9,18,20,4,16,7,26,18,0
426,25,12,9,11,5,9,23,39.1,14,21,2,19,21,46,24,0
427,0,0,0,0,0,0,0,0.0,0,0,0,0,1,1,4,2
428,54,32,28,19,7,19,46,41.3,27,25,7,18,15,69,21,0
429,33,20,23,9,1,21,35,60.0,14,33,2,31,10,43,27,0
430,7,4,2,4,1,4,13,30.8,9,9,1,8,3,10,2,0
431,58,42,36,18,4,34,58,58.6,24,27,6,21,29,87,89,0
432,0,0,0,0,0,0,3,0.0,3,1,0,1,0,0,5,3
433,22,14,16,4,2,11,18,61.1,7,21,3,18,8,30,36,0
434,24,16,13,7,4,11,19,57.9,8,5,1,4,13,37,21,0
435,10,7,4,5,1,2,11,18.2,9,15,9,6,12,22,56,0
436,6,4,0,5,1,1,3,33.3,2,6,1,5,2,8,11,0
437,9,4,7,2,0,4,5,80.0,1,10,6,4,19,28,39,0
438,3,3,2,1,0,1,5,20.0,4,5,2,3,5,8,16,1
439,8,7,1,5,2,4,7,57.1,3,2,0,2,0,8,2,0
440,1,0,0,0,1,0,0,0.0,0,0,0,0,0,1,0,0
441,4,0,2,2,0,2,4,50.0,2,2,1,1,2,6,5,0
442,0,0,0,0,0,0,0,0.0,0,0,0,0,0,0,3,0
443,1,1,0,1,0,1,1,100.0,0,1,0,1,0,1,0,0
444,1,1,1,0,0,0,0,0.0,0,0,0,0,0,1,0,0
445,0,0,0,0,0,0,0,0.0,0,0,0,0,0,0,0,0
446,0,0,0,0,0,0,0,0.0,0,0,0,0,0,0,0,0
447,1,1,1,0,0,0,1,0.0,1,0,0,0,1,2,0,0
448,0,0,0,0,0,0,0,0.0,0,0,0,0,0,0,0,0
449,0,0,0,0,0,0,0,0.0,0,0,0,0,0,0,0,0
450,55,35,43,12,0,32,48,66.7,16,50,27,23,45,100,172,2
451,41,24,21,15,5,15,30,50.0,15,23,4,19,16,57,27,2
452,1,0,1,0,0,1,2,50.0,1,1,0,1,1,2,9,0
453,59,40,27,23,9,27,64,42.2,37,25,2,23,19,78,32,0
454,26,19,18,6,2,16,25,64.0,9,21,10,11,17,43,89,0
455,54,31,29,16,9,29,41,70.7,12,29,5,24,20,74,75,2
456,45,25,15,27,3,26,42,61.9,16,29,6,23,15,60,26,1
457,9,6,5,2,2,4,15,26.7,11,19,0,19,1,10,2,0
458,33,19,13,16,4,18,47,38.3,29,16,6,10,9,42,37,0
459,36,14,15,15,6,17,27,63.0,10,24,5,19,7,43,23,0
460,20,13,14,6,0,13,19,68.4,6,23,14,9,4,24,77,0
461,1,1,0,0,1,1,10,10.0,9,2,1,1,2,3,5,0
462,4,2,1,0,3,1,2,50.0,1,6,3,3,1,5,4,0
463,12,9,9,1,2,8,20,40.0,12,5,1,4,5,17,20,0
464,22,10,12,10,0,10,17,58.8,7,14,5,9,13,35,30,1
465,12,7,9,3,0,4,10,40.0,6,11,7,4,15,27,37,1
466,13,9,2,8,3,7,17,41.2,10,9,0,9,2,15,6,0
467,20,10,5,14,1,5,17,29.4,12,11,0,11,9,29,8,0
468,14,11,9,3,2,3,10,30.0,7,10,5,5,14,28,48,0
469,17,9,8,8,1,8,17,47.1,9,13,7,6,21,38,41,1
470,11,4,2,6,3,6,10,60.0,4,5,0,5,4,15,4,0
471,7,4,0,4,3,2,7,28.6,5,4,0,4,3,10,4,0
472,19,11,10,6,3,9,18,50.0,9,11,2,9,16,35,23,0
473,0,0,0,0,0,0,0,0.0,0,0,0,0,1,1,1,2
474,1,1,0,0,1,0,1,0.0,1,2,1,1,0,1,7,0
475,3,0,0,2,1,1,2,50.0,1,0,0,0,0,3,0,0
476,4,1,3,0,1,0,3,0.0,3,9,2,7,5,9,7,0
477,1,0,1,0,0,1,4,25.0,3,1,0,1,0,1,2,0
478,0,0,0,0,0,0,0,0.0,0,0,0,0,0,0,0,0
479,37,26,25,10,2,15,24,62.5,9,46,35,11,32,69,157,1
480,74,48,30,36,8,23,52,44.2,29,62,7,55,25,99,29,0
481,51,39,15,20,16,16,35,45.7,19,26,1,25,14,65,8,0
482,1,0,1,0,0,1,1,100.0,0,0,0,0,0,1,16,2
483,39,28,33,6,0,28,41,68.3,13,50,31,19,15,54,121,0
484,26,16,18,6,2,18,23,78.3,5,28,17,11,23,49,126,1
485,30,18,13,13,4,10,26,38.5,16,26,11,15,41,71,37,0
486,41,25,25,13,3,24,40,60.0,16,22,10,12,21,62,52,0
487,34,17,18,13,3,15,32,46.9,17,30,12,18,5,39,27,1
488,40,22,13,23,4,19,29,65.5,10,16,4,12,6,46,30,2
489,40,24,24,13,3,24,38,63.2,14,23,6,17,19,59,56,0
490,35,22,12,16,7,13,36,36.1,23,19,0,19,6,41,18,0
491,2,0,0,0,2,0,1,0.0,1,4,0,4,1,3,3,0
492,0,0,0,0,0,0,1,0.0,1,0,0,0,0,0,7,1
493,49,25,27,13,9,30,53,56.6,23,21,3,18,12,61,18,0
494,25,14,19,5,1,20,28,71.4,8,17,6,11,2,27,35,0
495,14,9,9,5,0,7,11,63.6,4,9,4,5,6,20,27,1
496,15,6,5,8,2,5,15,33.3,10,5,1,4,6,21,11,0
497,3,3,1,1,1,2,5,40.0,3,3,1,2,3,6,7,0
498,22,13,12,7,3,11,22,50.0,11,8,0,8,11,33,18,0
499,4,2,1,1,2,3,10,30.0,7,7,0,7,2,6,0,0
500,3,1,0,1,2,0,6,0.0,6,7,1,6,3,6,10,0
501,16,11,7,9,0,7,16,43.8,9,9,1,8,3,19,14,0
502,5,2,2,2,1,2,8,25.0,6,12,2,10,1,6,7,0
503,0,0,0,0,0,0,4,0.0,4,2,1,1,1,1,0,0
504,2,1,0,2,0,1,1,100.0,0,4,0,4,2,4,3,0
505,4,2,0,2,2,2,2,100.0,0,5,0,5,2,6,2,0
506,5,3,1,2,2,3,3,100.0,0,1,0,1,1,6,1,0
507,0,0,0,0,0,0,0,0.0,0,0,0,0,0,0,0,0
508,1,1,0,0,1,1,1,100.0,0,0,0,0,0,1,0,0
509,0,0,0,0,0,0,0,0.0,0,0,0,0,0,0,0,0
510,0,0,0,0,0,0,0,0.0,0,0,0,0,0,0,0,0
511,0,0,0,0,0,0,0,0.0,0,0,0,0,0,0,0,0
512,0,0,0,0,0,0,0,0.0,0,0,0,0,0,0,0,0
513,41,27,12,14,15,19,40,47.5,21,38,4,34,18,59,9,0
514,56,34,33,22,1,29,44,65.9,15,48,32,16,29,85,156,4
515,65,42,28,29,8,28,70,40.0,42,47,12,35,27,92,61,2
516,0,0,0,0,0,0,0,0.0,0,0,0,0,0,0,6,3
517,35,15,23,11,1,15,20,75.0,5,51,36,15,29,64,147,0
518,45,23,15,24,6,26,49,53.1,23,23,7,16,19,64,62,0
519,28,13,13,12,3,9,25,36.0,16,22,5,17,10,38,37,0
520,12,7,1,8,3,4,8,50.0,4,6,1,5,5,17,10,0
521,30,18,14,15,1,17,35,48.6,18,12,1,11,19,49,41,1
522,19,13,8,4,7,10,24,41.7,14,19,3,16,11,30,27,1
523,23,13,14,7,2,12,26,46.2,14,22,18,4,8,31,63,0
524,21,14,8,13,0,10,22,45.5,12,13,5,8,4,25,29,1
525,37,26,21,14,2,23,34,67.6,11,17,3,14,9,46,32,0
526,19,16,10,5,4,10,21,47.6,11,14,3,11,9,28,22,0
527,7,6,4,3,0,3,13,23.1,10,10,2,8,7,14,33,0
528,21,10,6,12,3,5,17,29.4,12,24,4,20,10,31,5,0
529,23,11,11,11,1,8,16,50.0,8,19,3,16,5,28,8,0
530,6,4,0,1,5,3,4,75.0,1,6,0,6,1,7,0,0
531,0,0,0,0,0,0,0,0.0,0,0,0,0,0,0,5,1
532,8,3,1,3,4,3,4,75.0,1,10,1,9,1,9,0,0
533,4,1,0,2,2,0,7,0.0,7,5,0,5,4,8,1,0
534,10,5,7,2,1,5,15,33.3,10,13,0,13,4,14,8,1
535,7,6,4,2,1,1,9,11.1,8,4,0,4,1,8,3,0
536,5,3,2,3,0,2,3,66.7,1,1,0,1,3,8,9,0
537,7,4,2,3,2,4,5,80.0,1,3,0,3,1,8,1,0
538,2,1,1,1,0,1,3,33.3,2,4,2,2,4,6,8,0
539,5,4,1,4,0,2,4,50.0,2,3,0,3,0,5,4,0
540,4,3,2,0,2,2,3,66.7,1,0,0,0,0,4,0,0
541,2,0,1,0,1,0,2,0.0,2,2,0,2,1,3,2,0
542,3,0,2,0,1,2,2,100.0,0,1,0,1,1,4,0,0
543,0,0,0,0,0,0,0,0.0,0,0,0,0,0,0,0,0
544,0,0,0,0,0,0,0,0.0,0,1,0,1,1,1,0,0
545,0,0,0,0,0,0,0,0.0,0,0,0,0,0,0,0,0
546,0,0,0,0,0,0,0,0.0,0,1,1,0,0,0,0,0
547,13,8,1,6,6,5,22,22.7,17,19,2,17,1,14,40,0
548,0,0,0,0,0,0,0,0.0,0,1,0,1,1,1,19,1
549,31,20,8,14,9,13,44,29.5,31,29,4,25,15,46,11,0
550,37,22,26,8,3,20,30,66.7,10,31,16,15,28,65,128,1
551,40,22,7,28,5,22,44,50.0,22,25,9,16,21,61,36,0
552,43,29,21,18,4,18,43,41.9,25,18,8,10,25,68,31,6
553,22,10,11,11,0,12,18,66.7,6,28,17,11,25,47,76,0
554,13,10,8,4,1,9,15,60.0,6,17,5,12,16,29,49,1
555,48,33,18,25,5,27,46,58.7,19,23,13,10,14,62,33,2
556,17,8,7,9,1,2,21,9.5,19,17,0,17,13,30,9,0
557,36,24,25,5,6,21,25,84.0,4,19,5,14,10,46,51,0
558,25,15,11,10,4,10,18,55.6,8,18,15,3,24,49,68,2
559,25,17,16,9,0,15,27,55.6,12,31,10,21,16,41,38,0
560,13,6,6,3,4,5,13,38.5,8,5,1,4,6,19,8,0
561,34,21,22,7,5,20,36,55.6,16,12,2,10,9,43,34,0
562,24,15,14,7,3,10,22,45.5,12,20,10,10,10,34,44,0
563,10,4,6,4,0,0,9,0.0,9,16,7,9,7,17,22,0
564,17,8,7,5,5,7,15,46.7,8,10,0,10,3,20,9,0
565,12,10,5,5,2,7,19,36.8,12,16,1,15,1,13,3,0
566,16,8,9,6,1,9,25,36.0,16,7,0,7,1,17,5,0
567,8,4,3,4,1,2,10,20.0,8,6,4,2,8,16,10,0
568,9,7,4,3,2,3,11,27.3,8,9,2,7,6,15,7,0
569,3,2,2,1,0,1,2,50.0,1,8,6,2,0,3,22,0
570,0,0,0,0,0,0,0,0.0,0,0,0,0,0,0,3,1
571,6,3,2,4,0,4,11,36.4,7,3,2,1,4,10,8,0
572,2,1,1,1,0,1,2,50.0,1,1,1,0,2,4,0,0
573,1,1,0,0,1,1,2,50.0,1,7,2,5,1,2,2,0
574,2,2,1,1,0,1,1,100.0,0,6,1,5,0,2,0,0
575,0,0,0,0,0,0,0,0.0,0,0,0,0,0,0,1,0
576,0,0,0,0,0,0,0,0.0,0,0,0,0,0,0,0,0
577,18,13,8,8,2,9,25,36.0,16,9,0,9,7,25,23,0
578,29,20,13,10,6,15,25,60.0,10,22,7,15,32,61,62,1
579,47,32,20,21,6,22,49,44.9,27,23,5,18,16,63,29,0
580,39,23,25,14,0,15,28,53.6,13,46,30,16,25,64,93,1
581,20,10,5,13,2,10,20,50.0,10,20,1,19,4,24,16,1
582,0,0,0,0,0,0,1,0.0,1,0,0,0,0,0,9,1
583,49,29,26,22,1,20,42,47.6,22,27,5,22,24,73,38,0
584,36,18,30,6,0,20,26,76.9,6,33,23,10,23,59,77,2
585,23,14,8,9,6,9,20,45.0,11,13,4,9,8,31,9,0
586,25,19,14,10,1,16,29,55.2,13,14,6,8,5,30,31,0
587,18,11,14,4,0,8,14,57.1,6,22,19,3,17,35,99,1
588,20,13,10,9,1,10,27,37.0,17,18,6,12,14,34,29,0
589,2,1,1,1,0,2,3,66.7,1,0,0,0,0,2,5,1
590,4,2,2,2,0,1,3,33.3,2,5,0,5,3,7,7,0
591,3,1,0,2,1,2,6,33.3,4,1,1,0,1,4,8,0
592,27,14,17,8,2,16,24,66.7,8,14,7,7,18,45,41,1
593,17,11,13,4,0,11,22,50.0,11,24,7,17,11,28,36,0
594,23,12,8,12,3,11,26,42.3,15,13,2,11,7,30,16,0
595,12,5,8,1,3,6,11,54.5,5,15,7,8,11,23,28,0
596,16,13,9,7,0,7,12,58.3,5,10,2,8,1,17,17,0
597,19,11,12,5,2,9,19,47.4,10,13,4,9,8,27,15,0
598,13,9,4,7,2,3,9,33.3,6,3,0,3,1,14,4,0
599,8,6,5,3,0,2,10,20.0,8,8,2,6,14,22,6,1
600,13,7,7,3,3,6,18,33.3,12,4,1,3,4,17,7,1
601,6,3,0,2,4,1,3,33.3,2,7,0,7,0,6,4,0
602,9,5,6,3,0,6,8,75.0,2,10,7,3,2,11,20,0
603,8,6,4,3,1,5,10,50.0,5,11,6,5,10,18,28,0
604,11,7,9,2,0,9,14,64.3,5,7,3,4,3,14,19,0
605,0,0,0,0,0,0,0,0.0,0,0,0,0,0,0,0,1
606,2,0,2,0,0,0,1,0.0,1,3,0,3,0,2,2,0
607,0,0,0,0,0,0,0,0.0,0,6,5,1,4,4,21,0
608,10,7,4,5,1,5,6,83.3,1,1,0,1,1,11,7,0
609,4,1,2,2,0,0,1,0.0,1,2,0,2,2,6,2,0
610,0,0,0,0,0,0,0,0.0,0,1,0,1,0,0,0,0
611,0,0,0,0,0,0,1,0.0,1,2,0,2,0,0,4,0
612,1,1,1,0,0,1,2,50.0,1,0,0,0,0,1,0,0
613,0,0,0,0,0,0,0,0.0,0,0,0,0,0,0,0,0
614,0,0,0,0,0,0,0,0.0,0,0,0,0,0,0,0,0
615,0,0,0,0,0,0,1,0.0,1,1,0,1,1,1,10,1
616,59,28,33,22,4,34,59,57.6,25,24,12,12,28,87,110,1
617,81,51,35,41,5,42,112,37.5,70,31,5,26,23,104,23,0
618,27,13,10,12,5,10,28,35.7,18,12,0,12,7,34,17,0
619,45,33,21,18,6,27,63,42.9,36,35,6,29,29,74,47,0
620,53,31,24,23,6,29,42,69.0,13,28,8,20,43,96,37,0
621,29,21,15,13,1,16,29,55.2,13,25,17,8,28,57,79,0
622,19,10,10,6,3,10,36,27.8,26,22,0,22,7,26,14,0
623,12,6,6,5,1,6,12,50.0,6,22,19,3,26,38,67,0
624,37,24,18,15,4,18,43,41.9,25,28,4,24,15,52,14,0
625,45,33,19,21,5,19,59,32.2,40,39,3,36,19,64,23,1
626,9,8,3,5,1,2,10,20.0,8,8,1,7,2,11,12,0
627,14,6,3,7,4,1,11,9.1,10,8,1,7,1,15,5,0
628,38,24,19,14,5,15,31,48.4,16,14,3,11,8,46,23,0
629,17,11,4,9,4,7,13,53.8,6,8,0,8,4,21,3,0
630,5,4,2,2,1,3,10,30.0,7,7,0,7,6,11,1,0
631,29,18,23,4,2,13,16,81.3,3,7,1,6,12,41,23,0
632,19,15,8,6,5,5,17,29.4,12,19,3,16,9,28,11,0
633,9,4,1,4,4,1,10,10.0,9,5,1,4,4,13,13,0
634,14,9,6,8,0,11,16,68.8,5,10,6,4,4,18,17,0
635,3,1,0,0,3,1,10,10.0,9,4,0,4,6,9,2,0
636,25,20,6,14,5,11,18,61.1,7,11,4,7,7,32,8,0
637,4,1,3,1,0,1,2,50.0,1,3,0,3,3,7,7,0
638,0,0,0,0,0,0,0,0.0,0,0,0,0,0,0,0,1
639,6,4,4,1,1,4,5,80.0,1,2,0,2,3,9,2,0
640,4,3,1,2,1,2,5,40.0,3,1,0,1,2,6,3,0
641,0,0,0,0,0,0,0,0.0,0,4,0,4,1,1,1,0
642,1,1,0,1,0,0,3,0.0,3,0,0,0,0,1,2,0
643,0,0,0,0,0,0,0,0.0,0,0,0,0,0,0,0,0
644,1,0,1,0,0,0,0,0.0,0,0,0,0,0,1,0,0
645,1,1,0,1,0,1,1,100.0,0,1,0,1,0,1,0,0
646,0,0,0,0,0,0,0,0.0,0,0,0,0,0,0,0,0
647,0,0,0,0,0,0,0,0.0,0,0,0,0,0,0,0,0
648,10,5,2,2,6,4,20,20.0,16,9,2,7,4,14,5,0
649,1,0,1,0,0,1,3,33.3,2,0,0,0,1,2,9,2
650,33,18,13,15,5,17,52,32.7,35,31,0,31,12,45,7,0
651,41,21,18,17,6,26,42,61.9,16,20,5,15,16,57,74,0
652,94,58,46,37,11,42,115,36.5,73,47,11,36,34,128,48,0
653,50,33,30,18,2,27,52,51.9,25,36,16,20,45,95,116,0
654,31,17,15,15,1,12,20,60.0,8,42,26,16,29,60,110,0
655,34,17,15,15,4,14,32,43.8,18,24,8,16,13,47,45,1
656,31,16,13,16,2,14,49,28.6,35,14,2,12,18,49,22,1
657,29,21,14,11,4,15,39,38.5,24,26,6,20,20,49,12,0
658,16,11,11,4,1,10,19,52.6,9,28,19,9,22,38,67,0
659,41,31,24,15,2,16,34,47.1,18,15,6,9,16,57,26,0
660,26,18,14,10,2,13,35,37.1,22,12,5,7,9,35,27,0
661,5,4,1,3,1,1,5,20.0,4,7,2,5,4,9,7,0
662,14,7,3,10,1,6,21,28.6,15,10,3,7,12,26,7,0
663,6,2,5,1,0,1,2,50.0,1,6,6,0,3,9,46,0
664,3,1,1,2,0,2,10,20.0,8,5,0,5,7,10,5,0
665,11,6,4,3,4,3,10,30.0,7,15,2,13,8,19,6,0
666,18,13,9,9,0,8,27,29.6,19,8,0,8,7,25,9,0
667,6,4,4,2,0,2,6,33.3,4,5,3,2,8,14,38,0
668,21,13,15,5,1,7,11,63.6,4,14,8,6,5,26,37,0
669,15,7,8,6,1,3,9,33.3,6,7,2,5,11,26,16,0
670,11,4,3,6,2,8,13,61.5,5,4,3,1,3,14,10,0
671,5,2,4,1,0,3,6,50.0,3,3,0,3,5,10,1,0
672,4,4,1,3,0,3,9,33.3,6,5,3,2,5,9,14,0
673,0,0,0,0,0,0,0,0.0,0,0,0,0,0,0,0,1
674,10,4,3,6,1,5,14,35.7,9,10,4,6,4,14,6,0
675,9,7,7,2,0,8,15,53.3,7,5,3,2,7,16,13,0
676,10,6,5,5,0,4,7,57.1,3,1,0,1,1,11,3,0
677,4,1,1,1,2,1,3,33.3,2,3,0,3,1,5,1,0
678,0,0,0,0,0,0,0,0.0,0,0,0,0,0,0,0,0
679,9,9,2,5,2,4,7,57.1,3,6,1,5,1,10,5,0
680,2,2,1,0,1,0,8,0.0,8,1,0,1,1,3,1,0
681,2,0,1,1,0,0,1,0.0,1,3,1,2,6,8,5,0
682,0,0,0,0,0,0,0,0.0,0,0,0,0,0,0,0,0
683,3,2,2,1,0,2,3,66.7,1,0,0,0,1,4,0,1
684,5,5,4,1,0,2,5,40.0,3,1,0,1,2,7,3,0
685,1,1,0,1,0,0,1,0.0,1,2,2,0,0,1,0,0
686,2,1,2,0,0,0,4,0.0,4,0,0,0,0,2,1,0
687,0,0,0,0,0,0,0,0.0,0,0,0,0,0,0,0,0
688,0,0,0,0,0,0,0,0.0,0,0,0,0,0,0,0,0
689,0,0,0,0,0,0,0,0.0,0,0,0,0,0,0,1,0
690,0,0,0,0,0,0,0,0.0,0,0,0,0,0,0,0,0
691,2,1,1,0,1,2,2,100.0,0,0,0,0,0,2,0,0
692,0,0,0,0,0,0,0,0.0,0,1,0,1,1,1,18,0
693,43,31,14,24,5,18,37,48.6,19,25,1,24,16,59,17,0
694,28,21,6,14,8,9,22,40.9,13,12,3,9,1,29,37,0
695,30,20,19,10,1,16,33,48.5,17,31,24,7,31,61,104,1
696,42,29,25,16,1,15,25,60.0,10,31,10,21,32,74,56,0
697,75,40,33,35,7,34,84,40.5,50,41,16,25,27,102,34,0
698,41,29,30,9,2,27,35,77.1,8,31,25,6,41,82,120,0
699,71,42,27,37,7,27,92,29.3,65,29,4,25,31,102,22,0
700,33,28,13,11,9,17,58,29.3,41,23,0,23,19,52,9,0
701,61,39,29,25,7,38,74,51.4,36,35,7,28,17,78,48,0
702,39,29,15,22,2,20,37,54.1,17,22,9,13,12,51,22,1
703,48,31,30,16,2,34,50,68.0,16,11,4,7,20,68,33,1
704,20,14,12,6,2,14,29,48.3,15,17,4,13,11,31,9,0
705,21,12,11,7,3,15,26,57.7,11,20,2,18,18,39,22,1
706,81,49,47,22,12,30,55,54.5,25,16,3,13,19,100,58,0
707,13,6,11,2,0,4,8,50.0,4,11,5,6,16,29,53,0
708,15,8,5,6,4,9,26,34.6,17,13,2,11,3,18,6,0
709,26,14,11,10,5,8,18,44.4,10,12,4,8,15,41,9,0
710,17,12,13,4,0,11,23,47.8,12,12,8,4,9,26,40,0
711,13,5,4,7,2,4,5,80.0,1,6,0,6,1,14,2,0
712,3,1,1,2,0,3,12,25.0,9,4,0,4,0,3,1,0
713,3,2,3,0,0,2,2,100.0,0,3,2,1,0,3,14,0
714,28,19,9,10,9,11,26,42.3,15,11,1,10,6,34,9,0
715,0,0,0,0,0,0,0,0.0,0,1,0,1,1,1,1,0
716,0,0,0,0,0,0,0,0.0,0,0,0,0,0,0,2,0
717,0,0,0,0,0,0,0,0.0,0,2,2,0,1,1,11,0
718,0,0,0,0,0,0,0,0.0,0,1,0,1,1,1,0,0
719,2,2,0,1,1,0,0,0.0,0,1,0,1,0,2,1,0
720,1,1,0,0,1,1,1,100.0,0,0,0,0,0,1,0,0
721,0,0,0,0,0,0,2,0.0,2,0,0,0,1,1,0,0
722,1,1,0,1,0,0,0,0.0,0,0,0,0,0,1,0,0
723,48,28,29,18,1,27,35,77.1,8,40,26,14,25,73,148,1
724,46,29,21,24,1,30,52,57.7,22,45,30,15,29,75,85,1
725,40,22,19,16,5,17,46,37.0,29,27,7,20,15,55,30,0
726,62,45,31,21,10,37,68,54.4,31,21,5,16,14,76,52,0
727,74,48,42,26,6,32,69,46.4,37,24,10,14,40,114,64,1
728,18,13,2,10,6,4,14,28.6,10,17,0,17,8,26,15,0
729,49,31,21,24,4,27,61,44.3,34,23,12,11,29,78,38,1
730,42,26,14,25,3,23,66,34.8,43,29,10,19,25,67,30,1
731,36,24,10,18,8,12,34,35.3,22,12,1,11,7,43,14,0
732,32,22,8,10,14,12,33,36.4,21,26,6,20,11,43,11,0
733,0,0,0,0,0,0,0,0.0,0,1,0,1,0,0,10,3
734,3,1,1,1,1,1,15,6.7,14,1,0,1,2,5,0,0
735,21,12,8,10,3,10,39,25.6,29,9,3,6,11,32,5,0
736,0,0,0,0,0,0,0,0.0,0,0,0,0,0,0,3,0
737,31,21,11,10,10,13,28,46.4,15,21,3,18,3,34,21,0
738,31,19,5,22,4,16,36,44.4,20,11,1,10,13,44,9,0
739,13,9,8,4,1,6,12,50.0,6,13,11,2,10,23,56,0
740,19,16,8,6,5,7,19,36.8,12,13,1,12,7,26,10,0
741,20,9,12,6,2,12,20,60.0,8,12,4,8,7,27,15,0
742,18,9,11,6,1,8,9,88.9,1,5,3,2,11,29,13,0
743,0,0,0,0,0,0,0,0.0,0,0,0,0,0,0,3,2
744,7,6,2,2,3,1,8,12.5,7,6,0,6,5,12,2,0
745,10,5,4,5,1,3,16,18.8,13,5,1,4,9,19,4,0
746,4,3,4,0,0,0,0,0.0,0,3,1,2,7,11,35,1
747,1,1,1,0,0,0,0,0.0,0,3,1,2,5,6,5,0
748,5,5,3,2,0,5,12,41.7,7,2,1,1,2,7,5,0
749,2,2,0,1,1,0,3,0.0,3,2,1,1,0,2,0,0
750,2,1,0,2,0,1,4,25.0,3,0,0,0,3,5,0,0
751,3,2,2,1,0,2,2,100.0,0,1,1,0,0,3,0,0
752,0,0,0,0,0,0,0,0.0,0,0,0,0,1,1,1,0
753,0,0,0,0,0,0,2,0.0,2,1,0,1,0,0,0,0
754,2,2,2,0,0,2,3,66.7,1,0,0,0,0,2,1,0
755,0,0,0,0,0,0,1,0.0,1,0,0,0,0,0,19,3
756,46,31,22,19,5,22,36,61.1,14,37,26,11,58,104,123,1
757,34,20,23,10,1,17,26,65.4,9,43,30,13,61,95,202,2
758,41,30,22,18,1,20,49,40.8,29,42,12,30,40,81,60,0
759,18,11,4,13,1,9,28,32.1,19,12,0,12,13,31,19,0
760,32,19,14,15,3,12,33,36.4,21,16,3,13,13,45,25,0
761,18,10,3,8,7,9,19,47.4,10,15,3,12,3,21,29,0
762,37,24,16,13,8,18,33,54.5,15,33,5,28,12,49,21,1
763,62,37,19,33,10,30,66,45.5,36,28,6,22,30,92,17,0
764,79,51,46,28,5,54,119,45.4,65,41,7,34,48,127,56,0
765,37,16,17,16,4,16,34,47.1,18,17,3,14,38,75,48,0
766,56,31,33,18,5,27,51,52.9,24,11,1,10,24,80,37,0
767,5,3,2,2,1,2,8,25.0,6,17,0,17,4,9,9,0
768,18,9,10,5,3,5,12,41.7,7,16,7,9,16,34,37,0
769,33,20,14,19,0,16,37,43.2,21,9,1,8,16,49,12,0
770,25,12,11,12,2,15,28,53.6,13,9,2,7,4,29,18,0
771,1,1,1,0,0,1,5,20.0,4,5,2,3,3,4,8,0
772,10,7,7,3,0,5,7,71.4,2,3,2,1,6,16,33,0
773,6,4,2,1,3,4,11,36.4,7,2,1,1,3,9,1,0
774,7,5,2,3,2,0,1,0.0,1,4,0,4,3,10,4,0
775,22,18,11,11,0,16,33,48.5,17,4,1,3,8,30,7,0
776,8,5,2,3,3,2,5,40.0,3,3,0,3,2,10,3,0
777,8,5,5,3,0,6,11,54.5,5,3,1,2,3,11,9,0
778,4,2,1,2,1,2,3,66.7,1,4,1,3,0,4,4,0
779,3,0,1,1,1,2,5,40.0,3,5,2,3,1,4,4,0
780,1,1,0,1,0,0,0,0.0,0,2,0,2,0,1,0,0
781,0,0,0,0,0,0,0,0.0,0,0,0,0,0,0,6,0
782,3,2,3,0,0,2,4,50.0,2,2,0,2,1,4,3,0
783,0,0,0,0,0,0,0,0.0,0,0,0,0,0,0,1,0
784,2,1,0,1,1,1,6,16.7,5,0,0,0,0,2,0,0
785,1,1,0,0,1,0,0,0.0,0,0,0,0,1,2,0,0
786,1,0,0,1,0,1,1,100.0,0,1,0,1,1,2,0,0
787,0,0,0,0,0,0,0,0.0,0,0,0,0,0,0,0,0
788,0,0,0,0,0,0,0,0.0,0,1,0,1,0,0,0,0
789,0,0,0,0,0,0,1,0.0,1,0,0,0,0,0,0,0
790,0,0,0,0,0,0,0,0.0,0,0,0,0,0,0,0,0
791,0,0,0,0,0,0,1,0.0,1,0,0,0,2,2,19,2
792,69,54,25,28,16,35,88,39.8,53,45,12,33,79,148,85,3
793,51,28,20,22,9,15,46,32.6,31,31,6,25,26,77,20,0
794,106,63,40,52,14,45,93,48.4,48,36,10,26,32,138,23,1
795,15,5,1,11,3,4,12,33.3,8,8,2,6,10,25,15,0
796,35,21,12,18,5,10,43,23.3,33,28,1,27,11,46,10,0
797,41,21,11,24,6,19,43,44.2,24,37,7,30,27,68,25,0
798,24,16,8,11,5,8,19,42.1,11,18,0,18,8,32,11,0
799,24,10,16,7,1,13,25,52.0,12,10,7,3,25,49,69,0
800,18,11,13,5,0,9,15,60.0,6,21,18,3,30,48,75,1
801,36,26,16,17,3,25,47,53.2,22,19,6,13,21,57,34,0
802,54,31,30,21,3,31,70,44.3,39,21,2,19,26,80,26,0
803,18,10,3,12,3,9,35,25.7,26,27,1,26,12,30,7,0
804,9,6,5,4,0,5,12,41.7,7,12,10,2,17,26,33,1
805,19,12,12,5,2,7,13,53.8,6,24,8,16,13,32,45,0
806,15,9,10,4,1,10,13,76.9,3,19,15,4,14,29,51,1
807,13,9,3,7,3,3,15,20.0,12,14,0,14,2,15,8,0
808,16,11,6,7,3,9,15,60.0,6,13,4,9,1,17,3,0
809,6,5,5,1,0,4,7,57.1,3,15,10,5,9,15,30,1
810,4,4,0,2,2,2,12,16.7,10,11,0,11,2,6,2,0
811,22,15,5,11,6,5,13,38.5,8,18,0,18,8,30,6,0
812,0,0,0,0,0,0,0,0.0,0,0,0,0,0,0,5,0
813,13,5,5,1,7,6,23,26.1,17,8,2,6,7,20,5,0
814,7,3,2,1,4,6,11,54.5,5,6,0,6,0,7,2,0
815,2,2,1,1,0,0,1,0.0,1,3,0,3,0,2,6,0
816,3,1,3,0,0,1,1,100.0,0,0,0,0,5,8,6,0
817,7,4,3,2,2,4,4,100.0,0,4,1,3,3,10,11,0
818,4,3,0,3,1,0,1,0.0,1,1,0,1,1,5,0,0
819,4,1,2,1,1,2,2,100.0,0,2,1,1,2,6,2,0
820,3,0,2,0,1,2,3,66.7,1,2,1,1,1,4,2,0
821,5,4,2,3,0,1,2,50.0,1,3,0,3,1,6,0,0
822,1,1,1,0,0,1,1,100.0,0,0,0,0,2,3,11,0
823,0,0,0,0,0,0,1,0.0,1,1,1,0,1,1,1,1
824,1,1,1,0,0,1,1,100.0,0,0,0,0,0,1,0,0
825,0,0,0,0,0,0,0,0.0,0,0,0,0,0,0,0,0
826,0,0,0,0,0,0,1,0.0,1,0,0,0,0,0,15,2
827,57,37,28,26,3,27,50,54.0,23,27,14,13,31,88,36,2
828,14,9,1,12,1,7,24,29.2,17,15,6,9,6,20,11,2
829,38,20,9,24,5,16,50,32.0,34,31,9,22,21,59,22,0
830,54,31,25,21,8,25,60,41.7,35,47,2,45,9,63,18,1
831,11,6,10,1,0,5,8,62.5,3,18,14,4,22,33,96,2
832,29,18,12,11,6,20,30,66.7,10,27,12,15,16,45,32,0
833,22,17,9,8,5,11,28,39.3,17,13,3,10,6,28,5,0
834,31,24,12,12,7,15,26,57.7,11,35,18,17,13,44,27,0
835,31,15,11,14,6,16,31,51.6,15,11,1,10,10,41,18,0
836,26,19,7,12,7,15,29,51.7,14,13,4,9,12,38,17,1
837,12,10,4,7,1,5,11,45.5,6,12,7,5,8,20,44,0
838,36,21,21,13,2,22,40,55.0,18,16,8,8,14,50,38,0
839,15,9,5,7,3,9,19,47.4,10,12,1,11,3,18,10,0
840,34,19,15,15,4,16,34,47.1,18,20,3,17,10,44,12,0
841,11,5,7,3,1,8,10,80.0,2,12,9,3,9,20,30,0
842,16,11,7,7,2,8,20,40.0,12,5,1,4,10,26,28,0
843,11,8,5,4,2,6,10,60.0,4,11,6,5,8,19,50,1
844,17,14,12,5,0,10,19,52.6,9,14,8,6,16,33,34,0
845,16,11,7,6,3,3,8,37.5,5,14,1,13,3,19,8,0
846,11,5,3,5,3,4,15,26.7,11,10,1,9,4,15,3,0
847,17,9,9,6,2,11,17,64.7,6,9,4,5,9,26,6,0
848,9,5,5,2,2,6,7,85.7,1,8,4,4,2,11,12,0
849,8,5,4,1,3,2,6,33.3,4,6,2,4,2,10,5,0
850,4,3,2,2,0,4,5,80.0,1,5,4,1,2,6,14,0
851,0,0,0,0,0,0,0,0.0,0,0,0,0,0,0,1,0
852,3,1,2,1,0,2,2,100.0,0,2,1,1,4,7,7,0
853,0,0,0,0,0,0,1,0.0,1,1,1,0,1,1,13,0
854,0,0,0,0,0,0,2,0.0,2,1,1,0,1,1,0,0
855,0,0,0,0,0,0,0,0.0,0,0,0,0,0,0,0,0
856,2,1,2,0,0,1,2,50.0,1,1,0,1,2,4,4,0
857,0,0,0,0,0,0,1,0.0,1,2,0,2,0,0,1,0
858,8,4,4,0,4,3,5,60.0,2,2,0,2,3,11,2,0
859,1,1,0,0,1,1,1,100.0,0,0,0,0,0,1,1,0
860,2,1,1,0,1,2,2,100.0,0,0,0,0,0,2,0,0
861,0,0,0,0,0,0,1,0.0,1,0,0,0,1,1,1,0
862,0,0,0,0,0,0,0,0.0,0,0,0,0,0,0,0,0
863,0,0,0,0,0,0,2,0.0,2,0,0,0,1,1,18,1
864,41,26,28,12,1,27,39,69.2,12,35,19,16,41,82,138,1
865,48,27,18,26,4,21,44,47.7,23,33,12,21,42,90,32,0
866,16,7,6,7,3,5,18,27.8,13,16,2,14,6,22,1,0
867,26,15,10,13,3,16,33,48.5,17,19,7,12,16,42,27,0
868,59,39,19,24,16,30,65,46.2,35,48,3,45,8,67,18,0
869,54,25,22,27,5,29,51,56.9,22,19,2,17,37,91,29,1
870,19,10,8,8,3,7,18,38.9,11,12,2,10,2,21,2,0
871,27,16,23,4,0,16,25,64.0,9,23,15,8,18,45,69,1
872,34,27,15,14,5,13,27,48.1,14,27,7,20,22,56,50,0
873,41,19,21,19,1,14,45,31.1,31,31,4,27,19,60,27,0
874,18,10,4,11,3,7,16,43.8,9,11,1,10,8,26,19,0
875,23,13,5,15,3,8,19,42.1,11,15,1,14,10,33,9,1
876,12,4,5,7,0,5,9,55.6,4,12,5,7,11,23,41,0
877,16,7,6,8,2,13,22,59.1,9,17,1,16,7,23,3,0
878,14,11,6,8,0,11,21,52.4,10,9,5,4,16,30,29,0
879,17,13,13,4,0,10,14,71.4,4,7,5,2,16,33,45,0
880,8,5,6,2,0,1,6,16.7,5,21,14,7,12,20,30,0
881,15,11,5,7,3,9,19,47.4,10,10,7,3,11,26,8,0
882,6,3,3,2,1,3,4,75.0,1,8,3,5,13,19,46,0
883,5,3,5,0,0,2,6,33.3,4,10,5,5,6,11,22,0
884,9,7,0,7,2,2,8,25.0,6,3,0,3,1,10,0,0
885,11,9,7,3,1,7,9,77.8,2,1,0,1,8,19,10,0
886,11,8,3,6,2,2,7,28.6,5,2,1,1,6,17,4,0
887,15,8,5,8,2,5,16,31.3,11,5,0,5,5,20,8,0
888,0,0,0,0,0,0,0,0.0,0,0,0,0,0,0,2,1
889,3,1,0,2,1,1,5,20.0,4,4,0,4,1,4,0,0
890,7,2,4,3,0,4,8,50.0,4,6,1,5,3,10,12,0
891,6,4,1,5,0,3,8,37.5,5,10,0,10,9,15,10,0
892,4,4,2,1,1,2,5,40.0,3,1,1,0,2,6,2,0
893,5,3,3,2,0,3,7,42.9,4,1,0,1,1,6,0,0
894,2,1,1,0,1,2,4,50.0,2,0,0,0,0,2,1,0
895,3,1,2,1,0,2,3,66.7,1,1,1,0,0,3,4,0
896,2,0,0,2,0,0,1,0.0,1,2,1,1,0,2,0,0
897,1,1,1,0,0,1,1,100.0,0,2,1,1,0,1,0,0
898,1,1,0,1,0,0,0,0.0,0,0,0,0,0,1,0,0
899,0,0,0,0,0,0,0,0.0,0,0,0,0,0,0,1,0
900,0,0,0,0,0,0,0,0.0,0,0,0,0,0,0,0,0
901,0,0,0,0,0,0,0,0.0,0,0,0,0,0,0,0,0
902,0,0,0,0,0,0,0,0.0,0,0,0,0,0,0,0,0
903,68,48,38,19,11,39,58,67.2,19,35,11,24,16,84,70,0
904,23,8,8,11,4,14,44,31.8,30,20,2,18,9,32,7,0
905,35,24,12,14,9,15,41,36.6,26,19,3,16,16,51,13,0
906,32,18,22,9,1,18,33,54.5,15,21,12,9,23,55,87,0
907,16,14,10,6,0,9,23,39.1,14,26,16,10,16,32,104,0
908,53,33,28,24,1,33,58,56.9,25,30,5,25,36,89,90,1
909,19,11,7,10,2,12,36,33.3,24,14,2,12,10,29,9,0
910,38,23,14,18,6,19,28,67.9,9,30,14,16,31,69,44,1
911,0,0,0,0,0,0,1,0.0,1,0,0,0,0,0,3,5
912,4,3,1,3,0,0,4,0.0,4,7,2,5,2,6,10,0
913,12,7,0,6,6,2,7,28.6,5,9,2,7,9,21,18,0
914,26,13,5,17,4,12,36,33.3,24,13,2,11,21,47,20,0
915,33,16,13,14,6,18,39,46.2,21,12,2,10,10,43,10,0
916,34,25,23,11,0,22,40,55.0,18,18,7,11,15,49,63,0
917,27,20,15,6,6,8,16,50.0,8,11,0,11,5,32,8,0
918,16,6,12,3,1,13,18,72.2,5,18,7,11,9,25,67,2
919,26,17,8,13,5,15,24,62.5,9,18,4,14,17,43,31,0
920,15,7,3,11,1,5,19,26.3,14,12,0,12,5,20,12,0
921,0,0,0,0,0,0,1,0.0,1,0,0,0,0,0,2,1
922,0,0,0,0,0,0,0,0.0,0,0,0,0,1,1,7,0
923,18,13,9,8,1,11,31,35.5,20,11,3,8,12,30,7,0
924,26,16,12,10,4,12,32,37.5,20,10,1,9,12,38,16,0
925,18,12,10,5,3,13,15,86.7,2,5,0,5,6,24,8,0
926,17,8,10,6,1,11,19,57.9,8,10,0,10,7,24,8,0
927,2,2,1,1,0,0,3,0.0,3,10,8,2,3,5,35,0
928,11,5,1,6,4,5,17,29.4,12,5,2,3,4,15,2,0
929,5,5,1,3,1,1,5,20.0,4,5,1,4,1,6,2,0
930,7,6,4,2,1,4,9,44.4,5,4,2,2,4,11,9,0
931,7,3,7,0,0,4,8,50.0,4,8,3,5,6,13,10,0
932,7,5,3,4,0,5,8,62.5,3,4,1,3,5,12,2,0
933,2,1,1,1,0,0,0,0.0,0,0,0,0,2,4,2,0
934,1,1,1,0,0,1,6,16.7,5,2,0,2,2,3,3,0
935,1,0,0,0,1,0,0,0.0,0,0,0,0,1,2,0,0
936,2,1,2,0,0,2,2,100.0,0,0,0,0,0,2,0,0
937,0,0,0,0,0,0,0,0.0,0,0,0,0,0,0,0,0
938,0,0,0,0,0,0,0,0.0,0,0,0,0,1,1,5,3
939,48,35,30,16,2,25,43,58.1,18,29,18,11,34,82,116,1
940,76,42,31,39,6,43,102,42.2,59,51,7,44,24,100,22,0
941,37,25,24,10,3,23,46,50.0,23,37,26,11,31,68,147,0
942,69,45,38,25,6,39,66,59.1,27,26,3,23,39,108,57,0
943,54,31,33,15,6,29,68,42.6,39,28,14,14,41,95,105,0
944,44,22,11,28,5,24,62,38.7,38,29,6,23,17,61,22,0
945,13,7,3,4,6,5,17,29.4,12,11,3,8,4,17,12,1
946,14,11,6,6,2,6,20,30.0,14,18,3,15,8,22,21,0
947,49,30,20,25,4,18,34,52.9,16,24,5,19,23,72,24,0
948,20,14,9,9,2,8,28,28.6,20,22,3,19,13,33,13,0
949,17,10,6,7,4,7,24,29.2,17,12,1,11,6,23,3,0
950,28,13,14,8,6,12,26,46.2,14,18,3,15,16,44,20,0
951,15,8,7,5,3,6,24,25.0,18,17,0,17,3,18,5,0
952,18,12,10,7,1,9,17,52.9,8,16,11,5,17,35,46,0
953,58,40,30,27,1,29,66,43.9,37,21,2,19,27,85,22,0
954,27,18,9,15,3,10,28,35.7,18,16,2,14,5,32,9,0
955,18,10,5,9,4,9,18,50.0,9,11,0,11,3,21,1,0
956,18,14,5,8,5,10,15,66.7,5,8,2,6,15,33,16,0
957,16,12,7,7,2,7,12,58.3,5,7,2,5,4,20,12,1
958,7,5,3,3,1,3,10,30.0,7,4,3,1,3,10,7,0
959,1,0,1,0,0,1,1,100.0,0,0,0,0,1,2,1,1
960,3,3,1,1,1,1,9,11.1,8,1,0,1,3,6,1,0
961,12,7,7,2,3,5,8,62.5,3,14,3,11,6,18,10,0
962,5,1,3,2,0,3,3,100.0,0,2,1,1,2,7,13,1
963,2,2,0,1,1,1,3,33.3,2,3,0,3,0,2,4,0
964,1,1,0,1,0,0,6,0.0,6,1,0,1,1,2,0,0
965,2,2,1,1,0,0,0,0.0,0,3,1,2,2,4,15,0
966,0,0,0,0,0,0,0,0.0,0,0,0,0,0,0,1,0
967,1,1,1,0,0,1,4,25.0,3,2,1,1,3,4,3,0
968,1,0,0,1,0,0,1,0.0,1,0,0,0,0,1,0,0
969,0,0,0,0,0,0,1,0.0,1,0,0,0,0,0,0,0
970,2,2,2,0,0,2,3,66.7,1,1,0,1,1,3,11,0
971,62,36,19,38,5,33,76,43.4,43,36,13,23,18,80,31,1
972,47,32,15,26,6,25,65,38.5,40,31,11,20,27,74,34,1
973,28,21,19,8,1,18,27,66.7,9,36,23,13,24,52,89,2
974,27,19,10,15,2,12,23,52.2,11,15,0,15,4,31,10,0
975,28,19,13,12,3,15,35,42.9,20,19,3,16,20,48,22,0
976,41,26,26,12,3,27,46,58.7,19,17,9,8,16,57,34,1
977,23,13,14,8,1,14,30,46.7,16,17,3,14,6,29,26,0
978,21,11,13,8,0,12,22,54.5,10,27,14,13,18,39,99,0
979,36,23,15,17,4,20,48,41.7,28,27,2,25,11,47,18,1
980,32,21,20,11,1,19,23,82.6,4,27,24,3,13,45,71,2
981,23,15,6,16,1,11,35,31.4,24,11,0,11,11,34,5,0
982,7,4,1,1,5,3,8,37.5,5,7,1,6,5,12,15,0
983,19,14,9,9,1,6,13,46.2,7,12,2,10,6,25,13,0
984,24,14,6,12,6,10,39,25.6,29,19,2,17,3,27,15,0
985,14,10,9,3,2,11,16,68.8,5,10,8,2,13,27,37,0
986,21,14,11,7,3,10,16,62.5,6,15,3,12,18,39,22,0
987,16,13,10,3,3,11,18,61.1,7,10,3,7,3,19,25,0
988,6,0,1,4,1,2,13,15.4,11,7,1,6,7,13,8,0
989,8,5,0,4,4,5,11,45.5,6,3,0,3,0,8,1,0
990,13,5,6,6,1,6,13,46.2,7,8,2,6,9,22,6,0
991,6,2,2,1,3,2,8,25.0,6,8,1,7,0,6,2,0
992,7,7,1,3,3,3,14,21.4,11,11,2,9,6,13,2,0
993,0,0,0,0,0,0,0,0.0,0,0,0,0,0,0,3,0
994,6,4,4,1,1,3,6,50.0,3,5,1,4,7,13,13,0
995,6,4,2,4,0,1,5,20.0,4,4,0,4,6,12,2,0
996,5,4,4,1,0,5,7,71.4,2,2,1,1,1,6,7,0
997,3,0,0,2,1,1,2,50.0,1,1,0,1,0,3,2,0
998,0,0,0,0,0,0,1,0.0,1,2,2,0,2,2,5,0
999,3,3,1,2,0,2,9,22.2,7,2,0,2,3,6,4,0
1000,1,0,1,0,0,1,2,50.0,1,0,0,0,0,1,1,0
1001,4,1,3,0,1,1,1,100.0,0,2,1,1,2,6,0,0
1002,1,1,1,0,0,1,1,100.0,0,0,0,0,1,2,0,0
1003,3,3,3,0,0,1,2,50.0,1,2,0,2,1,4,0,0
1004,0,0,0,0,0,0,0,0.0,0,0,0,0,0,0,0,0
1005,0,0,0,0,0,0,1,0.0,1,0,0,0,0,0,1,0
1006,0,0,0,0,0,0,0,0.0,0,0,0,0,0,0,1,0
1007,0,0,0,0,0,0,1,0.0,1,0,0,0,0,0,1,0
1008,50,34,31,18,1,23,44,52.3,21,38,21,17,27,77,151,0
1009,0,0,0,0,0,0,0,0.0,0,0,0,0,2,2,9,1
1010,12,9,3,5,4,8,19,42.1,11,14,5,9,8,20,39,0
1011,74,41,30,39,5,30,76,39.5,46,52,28,24,37,111,99,0
1012,86,58,56,25,5,55,102,53.9,47,37,5,32,42,128,74,1
1013,23,15,20,3,0,18,37,48.6,19,28,15,13,27,50,116,1
1014,61,46,39,15,7,39,78,50.0,39,33,7,26,40,101,87,0
1015,47,30,13,26,8,20,41,48.8,21,23,7,16,13,60,2,0
1016,33,21,10,17,6,10,33,30.3,23,20,0,20,10,43,10,0
1017,19,10,10,6,3,12,39,30.8,27,18,2,16,8,27,6,2
1018,70,45,39,22,9,32,70,45.7,38,45,5,40,15,85,15,0
1019,18,14,13,5,0,9,13,69.2,4,16,11,5,8,26,64,1
1020,23,15,10,8,5,12,30,40.0,18,19,0,19,6,29,8,0
1021,14,6,6,7,1,6,33,18.2,27,10,1,9,9,23,10,0
1022,26,15,13,10,3,15,36,41.7,21,18,11,7,7,33,24,0
1023,2,1,0,1,1,0,3,0.0,3,2,1,1,2,4,5,0
1024,10,3,1,4,5,3,10,30.0,7,9,5,4,4,14,6,0
1025,13,10,9,3,1,8,16,50.0,8,6,1,5,3,16,4,0
1026,12,9,8,1,3,7,13,53.8,6,9,1,8,9,21,19,0
1027,7,4,2,4,1,2,5,40.0,3,8,0,8,3,10,5,0
1028,11,8,9,2,0,8,16,50.0,8,3,1,2,5,16,14,0
1029,21,9,9,10,2,8,26,30.8,18,4,0,4,9,30,7,0
1030,5,3,2,3,0,1,13,7.7,12,4,0,4,1,6,2,0
1031,2,1,1,0,1,0,1,0.0,1,4,1,3,0,2,9,0
1032,0,0,0,0,0,0,0,0.0,0,0,0,0,0,0,0,0
1033,3,2,3,0,0,2,12,16.7,10,7,0,7,0,3,1,0
1034,3,2,0,3,0,1,3,33.3,2,1,0,1,0,3,0,0
1035,0,0,0,0,0,0,0,0.0,0,1,0,1,0,0,0,0
1036,0,0,0,0,0,0,1,0.0,1,1,1,0,0,0,1,0
1037,0,0,0,0,0,0,0,0.0,0,0,0,0,0,0,0,0
1038,0,0,0,0,0,0,1,0.0,1,1,0,1,0,0,11,1
1039,46,30,34,12,0,26,41,63.4,15,53,36,17,27,73,126,0
1040,23,14,6,8,9,9,22,40.9,13,23,2,21,3,26,17,0
1041,43,26,20,17,6,22,57,38.6,35,39,5,34,33,76,36,0
1042,43,27,29,8,6,24,44,54.5,20,23,11,12,17,60,66,0
1043,24,15,13,9,2,17,31,54.8,14,24,12,12,19,43,57,0
1044,39,22,22,15,2,23,40,57.5,17,23,11,12,22,61,72,0
1045,27,20,18,6,3,13,22,59.1,9,24,6,18,31,58,56,0
1046,34,16,9,20,5,14,44,31.8,30,15,3,12,13,47,20,0
1047,26,12,13,10,3,14,46,30.4,32,28,10,18,16,42,30,0
1048,17,8,5,10,2,3,11,27.3,8,7,2,5,8,25,10,0
1049,6,3,1,2,3,1,2,50.0,1,11,1,10,1,7,11,0
1050,19,11,11,6,2,11,14,78.6,3,17,11,6,10,29,76,0
1051,37,22,20,15,2,18,40,45.0,22,29,9,20,20,57,28,0
1052,12,8,10,2,0,5,8,62.5,3,19,14,5,19,31,61,1
1053,26,14,13,11,2,16,40,40.0,24,14,0,14,5,31,17,0
1054,16,9,7,9,0,4,11,36.4,7,31,22,9,16,32,65,1
1055,23,13,12,10,1,13,36,36.1,23,13,1,12,8,31,13,1
1056,33,26,22,8,3,12,21,57.1,9,16,2,14,8,41,1,0
1057,15,11,8,5,2,9,22,40.9,13,8,0,8,6,21,4,0
1058,23,13,12,11,0,10,26,38.5,16,15,6,9,6,29,12,0
1059,7,4,1,5,1,3,10,30.0,7,7,1,6,1,8,4,0
1060,9,4,7,2,0,6,14,42.9,8,6,2,4,5,14,3,0
1061,8,4,5,2,1,3,14,21.4,11,12,0,12,3,11,2,0
1062,12,7,3,4,5,4,18,22.2,14,12,3,9,9,21,6,0
1063,5,2,3,2,0,2,10,20.0,8,10,2,8,1,6,2,0
1064,7,6,4,3,0,3,10,30.0,7,7,2,5,6,13,11,0
1065,2,1,1,1,0,1,5,20.0,4,0,0,0,3,5,4,0
1066,2,2,1,0,1,1,2,50.0,1,4,1,3,2,4,2,0
1067,7,5,2,3,2,3,7,42.9,4,2,1,1,1,8,10,0
1068,4,3,2,2,0,3,5,60.0,2,4,1,3,1,5,4,0
1069,0,0,0,0,0,0,0,0.0,0,3,0,3,0,0,2,0
1070,0,0,0,0,0,0,0,0.0,0,0,0,0,0,0,0,0
1071,1,0,1,0,0,1,1,100.0,0,0,0,0,3,4,5,1
1072,1,1,0,0,1,0,0,0.0,0,0,0,0,0,1,0,0
1073,0,0,0,0,0,0,1,0.0,1,1,0,1,0,0,7,0
1074,29,18,21,7,1,19,26,73.1,7,26,20,6,29,58,145,1
1075,114,72,70,35,9,74,123,60.2,49,47,4,43,49,163,92,1
1076,64,38,36,17,11,31,84,36.9,53,53,4,49,49,113,58,1
1077,36,23,12,14,10,11,28,39.3,17,29,0,29,8,44,22,0
1078,31,18,19,10,2,21,30,70.0,9,17,9,8,35,66,98,1
1079,24,14,8,14,2,10,24,41.7,14,14,1,13,7,31,4,0
1080,38,23,13,16,9,12,29,41.4,17,18,5,13,33,71,25,2
1081,36,23,12,20,4,17,47,36.2,30,17,0,17,12,48,9,0
1082,34,23,9,23,2,18,28,64.3,10,15,4,11,15,49,33,0
1083,28,18,8,14,6,15,22,68.2,7,12,1,11,9,37,5,1
1084,9,7,5,4,0,3,9,33.3,6,17,0,17,5,14,3,0
1085,16,10,12,4,0,7,17,41.2,10,30,19,11,21,37,66,0
1086,11,8,3,5,3,3,9,33.3,6,7,3,4,1,12,6,0
1087,6,4,0,4,2,4,17,23.5,13,7,0,7,6,12,3,0
1088,15,10,7,8,0,8,13,61.5,5,8,1,7,6,21,4,0
1089,15,7,6,5,4,4,10,40.0,6,2,0,2,5,20,11,0
1090,14,12,5,8,1,7,15,46.7,8,11,0,11,5,19,20,0
1091,8,5,0,3,5,2,5,40.0,3,3,0,3,1,9,3,0
1092,9,3,3,5,1,4,23,17.4,19,4,0,4,7,16,3,0
1093,7,6,1,5,1,1,7,14.3,6,4,1,3,1,8,1,0
1094,9,6,4,5,0,3,4,75.0,1,6,0,6,7,16,5,0
1095,5,4,4,1,0,2,3,66.7,1,4,0,4,1,6,10,0
1096,7,6,3,3,1,2,3,66.7,1,2,1,1,5,12,6,0
1097,15,11,5,8,2,4,12,33.3,8,3,0,3,7,22,3,0
1098,3,2,0,1,2,0,3,0.0,3,1,1,0,0,3,1,0
1099,7,7,3,4,0,2,3,66.7,1,2,0,2,3,10,1,0
1100,5,2,4,1,0,3,8,37.5,5,4,0,4,1,6,2,0
1101,3,3,2,1,0,1,1,100.0,0,2,2,0,4,7,9,0
1102,5,2,2,3,0,2,5,40.0,3,3,1,2,1,6,4,0
1103,0,0,0,0,0,0,0,0.0,0,0,0,0,0,0,0,0
1104,2,0,0,1,1,0,0,0.0,0,3,0,3,1,3,0,0
1105,0,0,0,0,0,0,0,0.0,0,0,0,0,0,0,3,0
1106,4,2,0,4,0,1,1,100.0,0,3,1,2,1,5,1,0
1107,2,2,0,2,0,0,2,0.0,2,2,1,1,0,2,1,0
1108,0,0,0,0,0,0,1,0.0,1,0,0,0,0,0,0,0
1109,0,0,0,0,0,0,0,0.0,0,0,0,0,0,0,0,0
1110,2,1,0,2,0,1,1,100.0,0,1,0,1,1,3,1,0
1111,1,0,1,0,0,0,0,0.0,0,0,0,0,0,1,11,0
1112,45,25,24,18,3,20,48,41.7,28,27,7,20,40,85,89,0
1113,26,17,14,11,1,12,19,63.2,7,26,14,12,14,40,125,1
1114,42,26,20,17,5,16,52,30.8,36,32,0,32,13,55,16,0
1115,43,20,24,16,3,24,55,43.6,31,22,5,17,18,61,45,0
1116,49,31,29,17,3,25,56,44.6,31,24,8,16,30,79,56,2
1117,7,5,1,4,2,2,18,11.1,16,18,8,10,4,11,35,0
1118,22,5,13,8,1,10,29,34.5,19,26,20,6,20,42,77,1
1119,42,23,18,19,5,15,37,40.5,22,26,3,23,16,58,16,0
1120,34,26,18,11,5,16,35,45.7,19,19,4,15,12,46,13,0
1121,40,24,18,18,4,24,57,42.1,33,29,3,26,15,55,15,0
1122,21,13,15,5,1,13,28,46.4,15,27,16,11,12,33,70,1
1123,19,13,15,4,0,9,13,69.2,4,23,17,6,17,36,84,0
1124,9,6,2,6,1,2,4,50.0,2,5,0,5,1,10,4,0
1125,31,21,12,15,4,17,30,56.7,13,11,4,7,9,40,25,0
1126,3,2,0,1,2,1,6,16.7,5,7,3,4,5,8,11,0
1127,7,5,4,3,0,6,14,42.9,8,4,0,4,2,9,0,0
1128,8,5,5,2,1,2,17,11.8,15,9,0,9,6,14,9,0
1129,14,7,7,5,2,8,18,44.4,10,10,1,9,3,17,3,0
1130,8,4,6,2,0,3,9,33.3,6,11,8,3,8,16,20,0
1131,15,7,9,4,2,5,22,22.7,17,5,1,4,11,26,7,1
1132,7,5,3,3,1,2,2,100.0,0,8,0,8,0,7,3,0
1133,15,7,10,4,1,7,17,41.2,10,10,2,8,6,21,3,0
1134,4,2,2,2,0,3,5,60.0,2,3,0,3,4,8,3,0
1135,4,3,2,2,0,3,5,60.0,2,2,1,1,4,8,19,0
1136,11,5,7,4,0,6,14,42.9,8,1,0,1,3,14,5,1
1137,8,3,1,3,4,1,5,20.0,4,2,0,2,0,8,1,0
1138,10,5,0,6,4,6,10,60.0,4,1,0,1,4,14,5,0
1139,13,7,6,7,0,3,9,33.3,6,9,3,6,3,16,4,0
1140,2,1,0,2,0,0,2,0.0,2,1,0,1,0,2,2,0
1141,6,3,0,5,1,4,12,33.3,8,3,0,3,1,7,9,0
1142,0,0,0,0,0,0,1,0.0,1,4,2,2,0,0,4,0
1143,1,1,0,1,0,1,2,50.0,1,0,0,0,2,3,0,0
1144,2,1,0,0,2,0,0,0.0,0,1,1,0,0,2,0,0
1145,1,1,0,1,0,0,0,0.0,0,0,0,0,0,1,0,0
1146,1,1,1,0,0,0,0,0.0,0,0,0,0,0,1,4,0
1147,0,0,0,0,0,0,0,0.0,0,0,0,0,0,0,0,0
1148,3,3,3,0,0,3,6,50.0,3,0,0,0,1,4,24,1
1149,49,25,15,28,6,24,55,43.6,31,41,8,33,26,75,27,0
1150,34,25,26,5,3,21,39,53.8,18,38,18,20,47,81,103,1
1151,96,60,54,40,2,29,70,41.4,41,68,10,58,62,158,69,1
1152,23,12,2,18,3,6,23,26.1,17,17,1,16,13,36,6,0
1153,38,24,29,9,0,18,24,75.0,6,21,12,9,32,70,82,0
1154,11,8,2,5,4,5,11,45.5,6,10,2,8,2,13,16,0
1155,73,46,24,43,6,40,85,47.1,45,31,1,30,26,99,22,1
1156,45,28,19,21,5,24,54,44.4,30,26,6,20,18,63,26,2
1157,32,20,6,16,10,13,37,35.1,24,17,1,16,8,40,3,0
1158,45,25,15,18,12,23,54,42.6,31,22,2,20,16,61,14,1
1159,17,11,5,10,2,5,23,21.7,18,17,3,14,14,31,8,0
1160,24,16,16,5,3,8,23,34.8,15,14,1,13,23,47,23,0
1161,20,9,14,5,1,14,20,70.0,6,11,8,3,30,50,66,1
1162,8,5,4,4,0,6,8,75.0,2,8,6,2,11,19,50,1
1163,24,16,9,12,3,11,18,61.1,7,12,3,9,5,29,26,1
1164,25,17,11,11,3,13,29,44.8,16,7,0,7,2,27,3,0
1165,6,5,3,2,1,1,4,25.0,3,2,1,1,2,8,4,0
1166,22,19,13,6,3,15,36,41.7,21,16,2,14,11,33,20,0
1167,14,9,3,11,0,10,21,47.6,11,6,0,6,7,21,14,0
1168,14,9,8,5,1,9,15,60.0,6,5,0,5,9,23,14,0
1169,16,7,8,5,3,7,18,38.9,11,8,0,8,8,24,15,0
1170,8,4,4,4,0,4,13,30.8,9,7,0,7,2,10,2,0
1171,7,6,5,2,0,4,12,33.3,8,9,2,7,8,15,11,1
1172,6,1,5,1,0,4,5,80.0,1,3,3,0,1,7,12,0
1173,3,3,0,0,3,0,1,0.0,1,3,0,3,0,3,1,0
1174,6,5,4,2,0,1,11,9.1,10,3,0,3,4,10,2,0
1175,6,3,1,4,1,0,4,0.0,4,2,0,2,3,9,0,0
1176,2,1,1,1,0,2,2,100.0,0,4,1,3,1,3,3,1
1177,0,0,0,0,0,0,0,0.0,0,0,0,0,0,0,0,0
1178,16,10,6,9,1,9,14,64.3,5,2,0,2,5,21,5,0
1179,1,1,0,1,0,1,3,33.3,2,1,0,1,0,1,0,0
1180,0,0,0,0,0,0,0,0.0,0,0,0,0,0,0,0,0
1181,0,0,0,0,0,0,0,0.0,0,0,0,0,0,0,0,0
1182,0,0,0,0,0,0,0,0.0,0,0,0,0,0,0,0,0
1183,1,1,1,0,0,1,1,100.0,0,0,0,0,0,1,15,1
1184,61,45,46,14,1,38,51,74.5,13,39,24,15,46,107,183,1
1185,7,3,1,4,2,2,6,33.3,4,11,5,6,2,9,24,0
1186,60,41,19,35,6,26,72,36.1,46,27,4,23,3,63,9,0
1187,22,15,16,6,0,16,21,76.2,5,32,23,9,36,58,164,1
1188,57,29,26,25,6,38,98,38.8,60,40,11,29,17,74,28,0
1189,29,21,19,8,2,17,40,42.5,23,22,4,18,11,40,23,0
1190,32,22,15,12,5,16,41,39.0,25,16,2,14,14,46,16,1
1191,43,25,17,24,2,15,34,44.1,19,25,7,18,22,65,28,0
1192,25,13,5,13,7,13,26,50.0,13,20,0,20,11,36,5,0
1193,20,15,11,7,2,12,23,52.2,11,18,5,13,29,49,44,1
1194,16,9,5,9,2,5,16,31.3,11,10,0,10,6,22,7,0
1195,31,16,8,19,4,14,34,41.2,20,16,1,15,25,56,26,0
1196,20,10,14,4,2,11,23,47.8,12,9,6,3,23,43,57,0
1197,52,31,30,13,9,28,48,58.3,20,26,8,18,15,67,40,1
1198,30,23,18,11,1,13,22,59.1,9,8,3,5,22,52,22,1
1199,21,15,9,10,2,11,19,57.9,8,16,3,13,15,36,22,0
1200,21,15,6,13,2,10,22,45.5,12,14,3,11,14,35,3,0
1201,14,8,10,4,0,7,20,35.0,13,11,3,8,6,20,20,0
1202,14,13,10,3,1,10,19,52.6,9,4,0,4,8,22,8,0
1203,7,5,2,3,2,1,6,16.7,5,3,0,3,2,9,9,0
1204,10,8,2,5,3,5,10,50.0,5,11,0,11,5,15,1,0
1205,9,7,8,0,1,2,4,50.0,2,3,2,1,7,16,10,0
1206,4,1,0,1,3,2,8,25.0,6,4,0,4,1,5,3,0
1207,15,9,7,7,1,6,16,37.5,10,14,4,10,5,20,11,0
1208,10,8,2,8,0,3,8,37.5,5,8,0,8,1,11,2,0
1209,1,0,1,0,0,1,1,100.0,0,5,4,1,6,7,20,0
1210,7,3,3,2,2,4,8,50.0,4,4,0,4,1,8,1,0
1211,0,0,0,0,0,0,1,0.0,1,0,0,0,0,0,0,1
1212,6,3,4,1,1,2,6,33.3,4,4,3,1,2,8,0,0
1213,3,1,1,2,0,1,4,25.0,3,5,2,3,3,6,5,0
1214,8,6,2,5,1,1,8,12.5,7,3,1,2,1,9,0,0
1215,5,3,3,1,1,3,7,42.9,4,2,1,1,2,7,8,0
1216,12,5,3,9,0,6,11,54.5,5,8,3,5,2,14,3,0
1217,0,0,0,0,0,0,1,0.0,1,2,0,2,0,0,0,0
1218,1,1,1,0,0,0,0,0.0,0,0,0,0,1,2,0,0
1219,3,1,0,2,1,1,2,50.0,1,3,0,3,0,3,3,0
1220,5,2,1,3,1,3,9,33.3,6,3,0,3,4,9,1,0
1221,0,0,0,0,0,0,0,0.0,0,0,0,0,1,1,6,0
1222,1,1,1,0,0,0,1,0.0,1,0,0,0,0,1,1,0
1223,0,0,0,0,0,0,0,0.0,0,1,0,1,1,1,0,0
1224,0,0,0,0,0,0,0,0.0,0,0,0,0,0,0,2,0
1225,0,0,0,0,0,0,0,0.0,0,0,0,0,0,0,0,0
1226,0,0,0,0,0,0,0,0.0,0,0,0,0,0,0,0,0
1227,0,0,0,0,0,0,1,0.0,1,0,0,0,0,0,0,0
1228,0,0,0,0,0,0,0,0.0,0,0,0,0,0,0,0,0
1229,1,0,1,0,0,1,3,33.3,2,0,0,0,0,1,17,2
1230,50,32,28,16,6,25,52,48.1,27,42,21,21,39,89,86,1
1231,21,13,15,5,1,8,18,44.4,10,24,15,9,17,38,132,2
1232,69,48,37,27,5,32,58,55.2,26,28,6,22,28,97,43,1
1233,39,31,32,5,2,26,41,63.4,15,38,24,14,38,77,134,2
1234,54,31,21,29,4,24,50,48.0,26,30,15,15,50,104,61,1
1235,27,16,12,10,5,13,28,46.4,15,21,7,14,12,39,14,1
1236,27,16,4,13,10,9,45,20.0,36,13,0,13,12,39,6,0
1237,24,16,11,10,3,15,26,57.7,11,8,0,8,3,27,5,0
1238,38,24,19,18,1,25,42,59.5,17,19,5,14,23,61,47,0
1239,32,18,17,11,4,16,22,72.7,6,20,4,16,21,53,63,0
1240,38,20,25,10,3,26,49,53.1,23,17,1,16,12,50,14,0
1241,18,13,7,8,3,8,20,40.0,12,8,1,7,12,30,24,0
1242,25,14,12,10,3,9,28,32.1,19,20,9,11,15,40,13,1
1243,5,4,1,3,1,1,5,20.0,4,9,1,8,2,7,18,0
1244,24,18,12,9,3,8,25,32.0,17,6,1,5,12,36,20,0
1245,14,6,10,3,1,3,7,42.9,4,13,11,2,11,25,80,0
1246,9,5,3,3,3,4,6,66.7,2,7,2,5,4,13,13,0
1247,7,4,1,4,2,4,11,36.4,7,6,1,5,1,8,10,0
1248,7,3,1,3,3,2,8,25.0,6,9,4,5,2,9,10,0
1249,7,5,1,6,0,1,10,10.0,9,8,2,6,8,15,4,0
1250,10,6,7,2,1,6,11,54.5,5,7,2,5,7,17,19,0
1251,4,2,2,1,1,2,4,50.0,2,8,5,3,4,8,32,0
1252,3,3,3,0,0,3,12,25.0,9,8,1,7,2,5,3,1
1253,17,10,12,3,2,12,27,44.4,15,5,1,4,1,18,7,0
1254,0,0,0,0,0,0,0,0.0,0,0,0,0,0,0,0,0
1255,5,4,3,1,1,3,4,75.0,1,2,1,1,2,7,8,0
1256,8,2,4,3,1,4,12,33.3,8,4,0,4,3,11,6,0
1257,5,5,0,4,1,1,3,33.3,2,2,1,1,0,5,1,0
1258,2,1,1,1,0,1,9,11.1,8,1,1,0,1,3,1,0
1259,1,1,0,1,0,1,5,20.0,4,2,1,1,0,1,2,0
1260,4,4,1,2,1,2,6,33.3,4,1,0,1,1,5,2,0
1261,0,0,0,0,0,0,1,0.0,1,0,0,0,0,0,1,0
1262,0,0,0,0,0,0,0,0.0,0,1,0,1,0,0,1,0
1263,5,4,3,2,0,2,4,50.0,2,0,0,0,1,6,1,0
1264,1,0,0,0,1,0,1,0.0,1,1,0,1,0,1,0,0
1265,2,0,2,0,0,0,0,0.0,0,0,0,0,0,2,0,0
1266,2,1,0,2,0,1,1,100.0,0,0,0,0,2,4,2,0
1267,1,0,1,0,0,1,1,100.0,0,1,1,0,1,2,0,0
1268,2,2,2,0,0,1,2,50.0,1,1,0,1,0,2,0,0
1269,0,0,0,0,0,0,0,0.0,0,0,0,0,0,0,0,0
1270,0,0,0,0,0,0,0,0.0,0,1,0,1,0,0,0,0
1271,2,1,2,0,0,2,2,100.0,0,0,0,0,0,2,20,2
1272,52,29,23,23,6,20,56,35.7,36,28,5,23,20,72,28,1
1273,91,63,55,29,7,54,87,62.1,33,39,10,29,31,122,70,1
1274,32,19,11,19,2,8,27,29.6,19,15,2,13,13,45,5,0
1275,56,28,19,26,11,33,76,43.4,43,23,2,21,33,89,18,0
1276,41,26,27,12,2,27,47,57.4,20,44,28,16,38,79,111,0
1277,16,5,10,6,0,11,22,50.0,11,29,21,8,18,34,129,2
1278,50,32,32,14,4,29,43,67.4,14,27,6,21,28,78,51,0
1279,23,14,8,10,5,13,34,38.2,21,18,3,15,15,38,12,0
1280,27,21,16,9,2,15,31,48.4,16,25,11,14,27,54,41,0
1281,44,25,11,30,3,17,36,47.2,19,34,10,24,20,64,33,0
1282,37,21,18,16,3,14,35,40.0,21,19,3,16,20,57,23,0
1283,15,10,3,11,1,7,15,46.7,8,12,4,8,23,38,15,1
1284,9,8,8,1,0,6,15,40.0,9,10,6,4,11,20,58,1
1285,2,0,0,1,1,0,6,0.0,6,6,1,5,0,2,14,0
1286,22,16,12,4,6,9,28,32.1,19,9,3,6,7,29,5,0
1287,11,6,7,4,0,5,8,62.5,3,14,8,6,12,23,40,0
1288,10,7,4,3,3,5,8,62.5,3,4,0,4,3,13,5,0
1289,18,13,9,7,2,7,14,50.0,7,8,0,8,4,22,6,0
1290,15,10,4,11,0,9,23,39.1,14,8,3,5,8,23,9,0
1291,5,4,1,3,1,0,5,0.0,5,4,1,3,1,6,6,0
1292,2,2,1,1,0,1,4,25.0,3,4,2,2,6,8,28,0
1293,10,9,8,2,0,5,15,33.3,10,8,3,5,8,18,13,1
1294,13,5,8,2,3,8,17,47.1,9,10,2,8,2,15,19,0
1295,5,1,1,4,0,0,8,0.0,8,6,2,4,1,6,4,0
1296,12,7,4,5,3,6,8,75.0,2,5,1,4,0,12,11,0
1297,11,4,5,5,1,6,10,60.0,4,6,2,4,5,16,13,0
1298,0,0,0,0,0,0,0,0.0,0,0,0,0,0,0,3,3
1299,4,2,1,2,1,3,7,42.9,4,3,0,3,4,8,3,0
1300,12,5,3,8,1,7,13,53.8,6,5,1,4,1,13,3,0
1301,5,4,3,2,0,2,3,66.7,1,5,1,4,1,6,9,0
1302,6,4,6,0,0,4,4,100.0,0,5,4,1,2,8,21,0
1303,0,0,0,0,0,0,0,0.0,0,0,0,0,0,0,1,0
1304,0,0,0,0,0,0,1,0.0,1,3,0,3,0,0,2,0
1305,4,3,3,1,0,3,7,42.9,4,2,0,2,2,6,4,0
1306,4,3,4,0,0,1,2,50.0,1,2,2,0,7,11,19,0
1307,0,0,0,0,0,0,0,0.0,0,5,4,1,5,5,18,0
1308,4,4,1,3,0,1,2,50.0,1,0,0,0,4,8,6,0
1309,2,2,1,1,0,0,1,0.0,1,1,1,0,1,3,1,0
1310,3,2,0,3,0,1,1,100.0,0,0,0,0,1,4,0,0
1311,0,0,0,0,0,0,0,0.0,0,0,0,0,1,1,3,0
1312,4,2,1,2,1,1,2,50.0,1,2,0,2,2,6,3,0
1313,0,0,0,0,0,0,1,0.0,1,1,0,1,0,0,0,0
1314,1,1,1,0,0,1,2,50.0,1,1,0,1,0,1,0,0
1315,2,0,0,1,1,2,3,66.7,1,0,0,0,0,2,0,0
1316,0,0,0,0,0,0,2,0.0,2,2,0,2,0,0,0,0
1317,0,0,0,0,0,0,0,0.0,0,1,0,1,0,0,0,0
1318,44,26,14,23,7,15,51,29.4,36,32,7,25,31,75,43,0
1319,60,40,20,36,4,25,92,27.2,67,51,11,40,31,91,21,1
1320,17,10,7,5,5,11,26,42.3,15,16,3,13,10,27,17,0
1321,32,15,22,9,1,12,22,54.5,10,31,21,10,32,64,107,0
1322,35,22,15,18,2,17,31,54.8,14,20,10,10,35,70,72,0
1323,11,7,0,6,5,6,20,30.0,14,11,3,8,1,12,11,0
1324,37,26,20,16,1,22,36,61.1,14,32,6,26,31,68,49,0
1325,25,17,19,6,0,18,28,64.3,10,28,17,11,28,53,91,1
1326,23,14,14,7,2,15,21,71.4,6,34,21,13,19,42,99,1
1327,17,7,13,3,1,10,31,32.3,21,13,5,8,15,32,24,0
1328,1,1,1,0,0,1,2,50.0,1,0,0,0,1,2,8,2
1329,24,16,17,7,0,13,38,34.2,25,18,2,16,9,33,21,0
1330,22,16,12,8,2,12,28,42.9,16,12,0,12,6,28,5,0
1331,38,16,17,19,2,12,37,32.4,25,21,5,16,28,66,24,0
1332,11,7,5,3,3,4,14,28.6,10,7,0,7,6,17,3,0
1333,31,19,11,16,4,13,43,30.2,30,20,1,19,10,41,11,0
1334,1,1,1,0,0,1,2,50.0,1,0,0,0,0,1,9,0
1335,0,0,0,0,0,0,1,0.0,1,0,0,0,0,0,6,2
1336,11,7,7,3,1,6,22,27.3,16,14,5,9,17,28,32,1
1337,5,4,1,2,2,2,16,12.5,14,5,1,4,2,7,4,0
1338,18,12,9,7,2,8,14,57.1,6,9,3,6,14,32,30,0
1339,12,6,9,3,0,5,14,35.7,9,19,5,14,11,23,28,0
1340,12,8,9,3,0,6,15,40.0,9,14,5,9,5,17,22,0
1341,9,7,6,3,0,7,9,77.8,2,15,10,5,4,13,41,0
1342,5,4,4,0,1,1,7,14.3,6,6,4,2,4,9,28,0
1343,8,5,3,2,3,4,15,26.7,11,9,0,9,0,8,5,0
1344,4,2,3,1,0,2,5,40.0,3,1,0,1,2,6,5,0
1345,5,1,2,3,0,2,9,22.2,7,1,0,1,6,11,2,0
1346,2,1,1,1,0,2,3,66.7,1,5,2,3,1,3,24,0
1347,8,6,0,8,0,4,10,40.0,6,3,1,2,4,12,11,0
1348,5,3,3,1,1,1,3,33.3,2,4,0,4,1,6,0,0
1349,2,2,0,2,0,0,2,0.0,2,2,0,2,4,6,2,0
1350,0,0,0,0,0,0,0,0.0,0,0,0,0,0,0,3,0
1351,2,1,0,0,2,0,2,0.0,2,0,0,0,0,2,1,0
1352,2,2,0,2,0,2,3,66.7,1,0,0,0,0,2,0,0
1353,4,2,2,2,0,1,5,20.0,4,3,0,3,0,4,0,0
1354,8,5,3,3,2,3,6,50.0,3,1,0,1,5,13,0,0
1355,2,1,0,2,0,1,5,20.0,4,0,0,0,0,2,0,0
1356,2,1,0,2,0,0,0,0.0,0,0,0,0,1,3,1,0
1357,0,0,0,0,0,0,1,0.0,1,1,0,1,0,0,1,0
1358,2,2,0,1,1,1,1,100.0,0,1,0,1,0,2,1,0
1359,0,0,0,0,0,0,0,0.0,0,0,0,0,0,0,0,0
1360,0,0,0,0,0,0,0,0.0,0,0,0,0,0,0,1,0
1361,1,0,1,0,0,1,1,100.0,0,0,0,0,0,1,1,0
1362,0,0,0,0,0,0,0,0.0,0,0,0,0,0,0,1,0
1363,0,0,0,0,0,0,0,0.0,0,0,0,0,0,0,0,0
1364,0,0,0,0,0,0,1,0.0,1,1,0,1,0,0,10,2
1365,29,21,11,14,4,9,30,30.0,21,29,8,21,19,48,42,0
1366,45,24,26,10,9,30,55,54.5,25,32,7,25,22,67,41,0
1367,19,9,10,7,2,5,16,31.3,11,28,23,5,23,42,97,1
1368,26,17,12,7,7,8,20,40.0,12,26,0,26,7,33,17,0
1369,27,18,7,14,6,9,29,31.0,20,36,2,34,9,36,3,0
1370,20,14,6,9,5,10,24,41.7,14,18,0,18,8,28,6,0
1371,34,25,17,15,2,17,24,70.8,7,21,10,11,24,58,52,3
1372,60,34,28,26,6,26,53,49.1,27,24,0,24,29,89,20,2
1373,30,20,11,12,7,15,26,57.7,11,27,3,24,27,57,43,1
1374,30,18,8,14,8,13,24,54.2,11,15,4,11,20,50,17,0
1375,6,4,0,1,5,1,4,25.0,3,6,1,5,0,6,13,0
1376,35,22,14,17,4,13,17,76.5,4,18,7,11,13,48,43,0
1377,38,20,19,13,6,22,33,66.7,11,18,3,15,9,47,26,0
1378,6,4,0,3,3,1,5,20.0,4,2,0,2,1,7,7,0
1379,16,7,2,10,4,7,17,41.2,10,10,2,8,6,22,5,0
1380,13,8,6,5,2,5,10,50.0,5,10,0,10,3,16,8,0
1381,10,4,2,4,4,3,7,42.9,4,4,1,3,2,12,1,0
1382,1,0,0,1,0,0,1,0.0,1,2,0,2,1,2,1,0
1383,4,3,2,0,2,2,2,100.0,0,1,1,0,0,4,7,0
1384,0,0,0,0,0,0,0,0.0,0,0,0,0,0,0,0,0
1385,4,2,0,3,1,0,3,0.0,3,0,0,0,0,4,1,0
1386,5,3,2,2,1,1,2,50.0,1,2,0,2,0,5,0,0
1387,0,0,0,0,0,0,0,0.0,0,0,0,0,1,1,0,0
1388,30,19,6,14,10,16,37,43.2,21,31,0,31,7,37,7,0
1389,39,25,21,16,2,23,42,54.8,19,33,20,13,40,79,150,1
1390,72,44,23,38,11,29,60,48.3,31,37,8,29,27,99,43,0
1391,2,2,2,0,0,2,4,50.0,2,0,0,0,0,2,13,4
1392,55,33,15,34,6,24,42,57.1,18,41,13,28,28,83,25,2
1393,40,22,9,21,10,18,39,46.2,21,24,2,22,16,56,7,1
1394,19,18,13,6,0,11,26,42.3,15,29,17,12,29,48,86,2
1395,6,3,1,4,1,2,5,40.0,3,8,1,7,6,12,29,0
1396,91,51,46,39,6,53,89,59.6,36,36,6,30,46,137,65,0
1397,28,13,6,8,14,4,15,26.7,11,17,0,17,6,34,5,0
1398,18,10,4,6,8,5,17,29.4,12,21,1,20,5,23,13,0
1399,21,14,16,5,0,4,8,50.0,4,23,18,5,20,41,78,1
1400,18,8,7,9,2,10,30,33.3,20,22,8,14,15,33,26,0
1401,28,18,15,11,2,15,30,50.0,15,11,5,6,2,30,16,1
1402,21,12,14,5,2,13,21,61.9,8,14,8,6,8,29,28,0
1403,5,3,3,2,0,3,12,25.0,9,9,0,9,0,5,4,0
1404,15,8,7,7,1,9,13,69.2,4,8,1,7,5,20,13,0
1405,15,9,6,8,1,6,8,75.0,2,5,0,5,7,22,5,0
1406,0,0,0,0,0,0,1,0.0,1,0,0,0,0,0,3,0
1407,5,1,1,4,0,3,7,42.9,4,4,0,4,0,5,1,0
1408,4,1,3,1,0,2,4,50.0,2,3,1,2,1,5,0,0
1409,1,0,1,0,0,1,2,50.0,1,0,0,0,0,1,1,0
1410,0,0,0,0,0,0,1,0.0,1,0,0,0,0,0,0,0
1411,3,1,2,1,0,0,0,0.0,0,2,0,2,0,3,0,0
1412,0,0,0,0,0,0,0,0.0,0,0,0,0,0,0,0,0
1413,1,1,1,0,0,0,0,0.0,0,0,0,0,0,1,1,0
1414,0,0,0,0,0,0,0,0.0,0,0,0,0,1,1,0,0
1415,13,9,4,4,5,6,18,33.3,12,12,4,8,6,19,14,0
1416,45,33,25,15,5,26,39,66.7,13,32,4,28,14,59,28,1
1417,41,23,18,14,9,24,54,44.4,30,44,8,36,31,72,42,1
1418,15,8,6,6,3,4,19,21.1,15,12,0,12,7,22,3,0
1419,47,24,29,13,5,30,53,56.6,23,30,4,26,26,73,49,1
1420,1,1,1,0,0,0,0,0.0,0,0,0,0,0,1,14,3
1421,37,24,21,11,5,12,24,50.0,12,29,19,10,45,82,70,2
1422,40,25,9,21,10,14,36,38.9,22,25,1,24,16,56,5,0
1423,26,16,5,10,11,13,35,37.1,22,22,0,22,3,29,6,0
1424,34,21,21,11,2,15,29,51.7,14,19,7,12,19,53,56,3
1425,56,36,25,20,11,22,52,42.3,30,42,6,36,18,74,13,2
1426,15,12,4,8,3,6,11,54.5,5,14,10,4,19,34,52,0
1427,32,21,14,11,7,13,21,61.9,8,14,1,13,20,52,27,1
1428,12,7,5,3,4,9,17,52.9,8,15,1,14,2,14,5,0
1429,28,16,10,14,4,17,33,51.5,16,13,3,10,17,45,12,0
1430,19,16,6,9,4,9,15,60.0,6,7,1,6,15,34,5,1
1431,11,8,5,5,1,5,6,83.3,1,20,12,8,10,21,48,1
1432,1,0,1,0,0,1,1,100.0,0,0,0,0,0,1,3,2
1433,17,12,8,5,4,6,14,42.9,8,5,0,5,7,24,7,0
1434,12,2,3,4,5,4,6,66.7,2,11,0,11,6,18,6,0
1435,8,5,0,5,3,2,13,15.4,11,5,0,5,3,11,2,0
1436,4,4,2,1,1,3,3,100.0,0,0,0,0,2,6,0,0
1437,0,0,0,0,0,0,5,0.0,5,3,0,3,0,0,2,0
1438,2,0,2,0,0,1,2,50.0,1,1,0,1,1,3,2,0
1439,2,0,1,1,0,2,2,100.0,0,3,0,3,0,2,1,0
1440,2,0,2,0,0,1,2,50.0,1,0,0,0,0,2,0,0
1441,0,0,0,0,0,0,0,0.0,0,0,0,0,1,1,0,0
1442,0,0,0,0,0,0,0,0.0,0,0,0,0,0,0,0,0
1443,0,0,0,0,0,0,0,0.0,0,0,0,0,0,0,1,0
1444,3,3,0,1,2,0,6,0.0,6,19,3,16,5,8,14,0
1445,30,17,10,11,9,15,31,48.4,16,23,0,23,16,46,4,0
1446,58,35,24,29,5,34,58,58.6,24,51,9,42,27,85,82,2
1447,81,50,35,38,8,21,53,39.6,32,41,8,33,19,100,27,0
1448,68,39,32,26,10,27,58,46.6,31,49,4,45,33,101,37,0
1449,19,12,10,9,0,10,12,83.3,2,35,13,22,12,31,94,2
1450,48,29,28,19,1,32,44,72.7,12,36,14,22,29,77,69,0
1451,1,1,1,0,0,0,0,0.0,0,0,0,0,0,1,7,3
1452,42,27,24,16,2,23,41,56.1,18,28,6,22,21,63,37,0
1453,20,12,8,10,2,9,18,50.0,9,22,13,9,16,36,76,1
1454,13,5,2,7,4,2,9,22.2,7,23,2,21,3,16,27,0
1455,26,18,14,8,4,10,22,45.5,12,7,0,7,13,39,12,1
1456,15,10,7,7,1,4,13,30.8,9,25,12,13,13,28,64,1
1457,19,8,8,9,2,10,21,47.6,11,19,7,12,11,30,14,1
1458,0,0,0,0,0,0,0,0.0,0,0,0,0,0,0,8,1
1459,13,8,1,9,3,4,14,28.6,10,13,3,10,4,17,15,0
1460,26,13,10,12,4,14,38,36.8,24,20,1,19,5,31,14,0
1461,33,18,16,15,2,16,25,64.0,9,12,2,10,8,41,15,0
1462,7,3,2,5,0,5,12,41.7,7,7,0,7,0,7,5,0
1463,8,6,1,6,1,6,8,75.0,2,5,0,5,1,9,2,0
1464,2,1,0,1,1,0,0,0.0,0,1,0,1,1,3,0,0
1465,3,1,0,2,1,1,3,33.3,2,8,0,8,0,3,1,0
1466,2,1,2,0,0,1,1,100.0,0,0,0,0,2,4,2,0
1467,1,0,1,0,0,0,0,0.0,0,0,0,0,1,2,4,0
1468,0,0,0,0,0,0,0,0.0,0,0,0,0,0,0,0,0
1469,0,0,0,0,0,0,0,0.0,0,0,0,0,0,0,0,0
1470,70,50,36,27,7,41,65,63.1,24,52,25,27,45,115,101,3
1471,0,0,0,0,0,0,1,0.0,1,0,0,0,0,0,11,0
1472,7,2,1,6,0,2,8,25.0,6,17,4,13,2,9,25,0
1473,17,14,8,8,1,10,27,37.0,17,20,3,17,8,25,18,0
1474,39,24,18,20,1,23,42,54.8,19,31,12,19,12,51,34,0
1475,63,45,37,23,3,28,48,58.3,20,30,7,23,22,85,41,2
1476,11,7,5,3,3,2,6,33.3,4,11,4,7,2,13,8,0
1477,41,23,26,11,4,27,47,57.4,20,31,7,24,10,51,35,3
1478,52,34,34,12,6,30,53,56.6,23,33,11,22,33,85,82,0
1479,37,25,20,14,3,12,27,44.4,15,17,2,15,5,42,18,0
1480,30,22,15,9,6,16,30,53.3,14,22,4,18,13,43,26,0
1481,18,10,14,3,1,11,16,68.8,5,25,14,11,25,43,58,2
1482,14,7,6,7,1,2,17,11.8,15,11,2,9,4,18,7,0
1483,20,12,11,8,1,10,18,55.6,8,28,3,25,17,37,18,1
1484,20,12,8,11,1,11,23,47.8,12,12,2,10,8,28,20,0
1485,34,21,21,11,2,24,34,70.6,10,22,7,15,16,50,37,0
1486,5,4,1,3,1,0,4,0.0,4,11,0,11,4,9,6,0
1487,19,13,7,8,4,11,22,50.0,11,18,5,13,11,30,19,0
1488,16,14,9,4,3,8,20,40.0,12,11,0,11,3,19,5,0
1489,1,1,1,0,0,1,1,100.0,0,0,0,0,0,1,2,1
1490,5,1,3,2,0,3,13,23.1,10,8,2,6,4,9,22,0
1491,1,0,0,1,0,1,1,100.0,0,4,1,3,0,1,7,0
1492,4,1,2,2,0,3,7,42.9,4,4,1,3,2,6,4,0
1493,2,2,1,1,0,2,4,50.0,2,3,1,2,1,3,3,0
1494,9,6,3,4,2,2,5,40.0,3,5,1,4,2,11,5,0
1495,6,3,6,0,0,6,7,85.7,1,3,2,1,2,8,7,0
1496,3,2,2,1,0,2,5,40.0,3,1,1,0,0,3,3,0
1497,1,0,0,1,0,1,2,50.0,1,0,0,0,0,1,1,0
1498,1,1,1,0,0,1,2,50.0,1,0,0,0,0,1,1,0
1499,1,0,1,0,0,1,1,100.0,0,1,0,1,0,1,4,0
1500,1,0,0,1,0,1,1,100.0,0,0,0,0,0,1,0,0
1501,0,0,0,0,0,0,0,0.0,0,0,0,0,0,0,0,0
1502,62,37,38,23,1,31,53,58.5,22,51,22,29,47,109,152,2
1503,0,0,0,0,0,0,0,0.0,0,0,0,0,1,1,9,1
1504,38,23,26,12,0,17,27,63.0,10,33,24,9,32,70,136,2
1505,63,33,38,19,6,39,59,66.1,20,29,12,17,36,99,99,0
1506,21,11,7,8,6,6,16,37.5,10,13,0,13,11,32,7,0
1507,44,29,15,17,12,18,41,43.9,23,28,7,21,9,53,39,1
1508,44,24,18,19,7,19,36,52.8,17,33,4,29,39,83,47,2
1509,43,26,17,16,10,17,31,54.8,14,40,3,37,20,63,15,0
1510,51,34,18,25,8,28,62,45.2,34,19,3,16,14,65,10,0
1511,27,17,7,12,8,8,18,44.4,10,37,1,36,5,32,19,0
1512,32,18,18,10,4,15,28,53.6,13,34,7,27,29,61,30,1
1513,40,25,19,16,5,21,38,55.3,17,24,5,19,15,55,36,0
1514,26,17,6,18,2,19,26,73.1,7,18,1,17,7,33,18,2
1515,54,30,34,17,3,29,64,45.3,35,30,2,28,16,70,30,0
1516,11,7,3,6,2,4,6,66.7,2,10,0,10,2,13,4,0
1517,2,2,0,2,0,0,0,0.0,0,2,2,0,2,4,6,0
1518,8,3,3,3,2,3,7,42.9,4,5,1,4,3,11,1,0
1519,7,3,7,0,0,4,5,80.0,1,3,1,2,6,13,23,1
1520,3,2,1,1,1,0,0,0.0,0,0,0,0,0,3,1,0
1521,4,2,2,2,0,3,6,50.0,3,2,1,1,2,6,5,0
1522,0,0,0,0,0,0,0,0.0,0,0,0,0,0,0,3,0
1523,0,0,0,0,0,0,0,0.0,0,0,0,0,0,0,1,0
1524,3,3,1,2,0,1,3,33.3,2,1,0,1,2,5,2,0
1525,3,1,0,3,0,1,4,25.0,3,2,0,2,1,4,1,0
1526,2,2,1,1,0,1,1,100.0,0,2,0,2,0,2,0,0
1527,0,0,0,0,0,0,0,0.0,0,0,0,0,2,2,4,0
1528,1,1,1,0,0,0,0,0.0,0,0,0,0,0,1,0,0
1529,6,4,0,5,1,4,6,66.7,2,0,0,0,1,7,1,0
1530,2,1,1,0,1,2,7,28.6,5,5,1,4,0,2,1,0
1531,3,3,1,2,0,2,3,66.7,1,0,0,0,0,3,2,0
1532,1,0,0,0,1,0,0,0.0,0,3,2,1,0,1,1,0
1533,0,0,0,0,0,0,0,0.0,0,0,0,0,0,0,0,0
1534,1,1,0,1,0,1,1,100.0,0,0,0,0,0,1,1,0
1535,0,0,0,0,0,0,0,0.0,0,0,0,0,0,0,0,0
1536,1,1,1,0,0,1,2,50.0,1,0,0,0,0,1,19,2
1537,20,12,5,11,4,4,19,21.1,15,21,1,20,9,29,12,0
1538,31,19,10,15,6,18,40,45.0,22,22,8,14,23,54,68,0
1539,48,35,32,14,2,19,33,57.6,14,43,21,22,46,94,106,2
1540,32,18,11,15,6,14,32,43.8,18,22,6,16,22,54,36,0
1541,73,42,40,27,6,33,63,52.4,30,38,12,26,72,145,67,1
1542,54,28,31,19,4,22,54,40.7,32,41,20,21,52,106,90,2
1543,11,2,5,4,2,6,13,46.2,7,14,2,12,10,21,12,2
1544,13,6,4,7,2,9,15,60.0,6,25,8,17,6,19,24,0
1545,28,15,17,10,1,15,30,50.0,15,29,17,12,27,55,109,1
1546,22,12,10,8,4,8,16,50.0,8,13,2,11,14,36,15,0
1547,18,11,9,5,4,12,23,52.2,11,17,3,14,10,28,20,0
1548,14,10,7,7,0,8,13,61.5,5,16,13,3,9,23,54,0
1549,24,16,15,8,1,17,36,47.2,19,17,4,13,10,34,23,1
1550,16,12,9,7,0,6,19,31.6,13,11,1,10,6,22,12,0
1551,35,18,22,12,1,26,35,74.3,9,28,8,20,18,53,32,0
1552,21,10,12,8,1,17,29,58.6,12,13,2,11,8,29,33,0
1553,16,9,12,4,0,8,17,47.1,9,12,8,4,8,24,14,0
1554,10,9,8,2,0,4,17,23.5,13,9,1,8,1,11,10,0
1555,14,11,13,1,0,7,17,41.2,10,7,2,5,3,17,22,1
1556,3,1,3,0,0,1,4,25.0,3,6,2,4,1,4,7,0
1557,8,4,6,1,1,2,9,22.2,7,3,0,3,1,9,2,0
1558,0,0,0,0,0,0,1,0.0,1,2,0,2,0,0,3,0
1559,0,0,0,0,0,0,0,0.0,0,2,1,1,0,0,0,0
1560,1,0,1,0,0,0,0,0.0,0,1,1,0,0,1,0,0
1561,1,0,1,0,0,1,2,50.0,1,1,0,1,0,1,0,0
1562,3,3,2,0,1,1,1,100.0,0,0,0,0,0,3,0,0
1563,0,0,0,0,0,0,1,0.0,1,0,0,0,0,0,0,0
1564,0,0,0,0,0,0,0,0.0,0,0,0,0,0,0,0,0
1565,0,0,0,0,0,0,0,0.0,0,0,0,0,1,1,0,0
1566,85,49,58,24,3,38,74,51.4,36,66,32,34,49,134,158,1
1567,3,0,3,0,0,3,5,60.0,2,0,0,0,0,3,6,1
1568,21,12,6,11,4,7,25,28.0,18,32,8,24,12,33,58,0
1569,32,18,16,13,3,19,48,39.6,29,40,4,36,12,44,21,0
1570,44,24,24,14,6,19,36,52.8,17,34,19,15,31,75,70,0
1571,77,49,35,24,18,28,55,50.9,27,48,1,47,18,95,31,0
1572,60,33,33,21,6,32,56,57.1,24,32,7,25,40,100,54,1
1573,43,26,14,24,5,25,59,42.4,34,33,9,24,25,68,88,0
1574,40,24,25,14,1,19,35,54.3,16,27,17,10,16,56,101,1
1575,48,26,26,20,2,21,42,50.0,21,37,7,30,26,74,57,0
1576,19,12,5,11,3,8,20,40.0,12,28,4,24,12,31,21,0
1577,24,16,13,7,4,13,22,59.1,9,16,6,10,14,38,21,0
1578,22,13,8,12,2,9,24,37.5,15,17,0,17,4,26,15,0
1579,27,11,21,6,0,8,20,40.0,12,16,10,6,21,48,29,1
1580,17,10,9,6,2,7,16,43.8,9,12,1,11,4,21,17,0
1581,14,9,2,10,2,5,25,20.0,20,9,0,9,1,15,3,0
1582,11,9,6,3,2,7,12,58.3,5,9,2,7,10,21,12,0
1583,9,6,4,4,1,5,11,45.5,6,3,2,1,4,13,13,0
1584,4,4,3,0,1,2,3,66.7,1,2,0,2,2,6,2,0
1585,1,1,0,1,0,0,3,0.0,3,2,0,2,1,2,6,0
1586,0,0,0,0,0,0,0,0.0,0,0,0,0,0,0,0,0
1587,0,0,0,0,0,0,0,0.0,0,0,0,0,0,0,0,0
1588,8,3,4,3,1,6,14,42.9,8,2,0,2,4,12,25,0
1589,64,38,29,25,10,31,53,58.5,22,36,6,30,20,84,43,0
1590,35,20,7,22,6,14,46,30.4,32,36,7,29,11,46,17,2
1591,37,23,21,14,2,18,33,54.5,15,39,17,22,24,61,102,0
1592,3,1,3,0,0,3,3,100.0,0,0,0,0,0,3,7,3
1593,52,22,21,23,8,18,50,36.0,32,42,23,19,23,75,55,0
1594,53,32,38,15,0,36,48,75.0,12,45,29,16,35,88,129,0
1595,31,15,17,13,1,16,31,51.6,15,31,20,11,17,48,57,0
1596,64,38,33,27,4,30,70,42.9,40,41,8,33,41,105,56,0
1597,45,29,28,13,4,29,41,70.7,12,27,7,20,13,58,41,0
1598,42,18,20,17,5,15,39,38.5,24,18,1,17,13,55,6,0
1599,28,15,21,4,3,18,38,47.4,20,24,8,16,14,42,49,1
1600,34,23,7,20,7,15,21,71.4,6,12,0,12,5,39,17,0
1601,26,15,13,11,2,12,18,66.7,6,14,7,7,19,45,61,1
1602,10,7,2,4,4,5,16,31.3,11,8,2,6,2,12,10,0
1603,5,1,2,2,1,3,9,33.3,6,9,1,8,2,7,6,0
1604,21,16,11,9,1,11,25,44.0,14,17,6,11,13,34,28,1
1605,0,0,0,0,0,0,0,0.0,0,0,0,0,0,0,2,0
1606,14,11,8,6,0,7,13,53.8,6,12,7,5,9,23,36,1
1607,18,13,12,3,3,16,24,66.7,8,8,1,7,13,31,26,0
1608,1,1,1,0,0,1,4,25.0,3,3,1,2,0,1,1,0
1609,1,1,0,1,0,1,1,100.0,0,2,1,1,0,1,1,0
1610,6,4,1,5,0,3,3,100.0,0,3,1,2,1,7,1,0
1611,1,1,1,0,0,0,1,0.0,1,2,0,2,2,3,1,0
1612,3,2,2,1,0,2,2,100.0,0,2,0,2,2,5,8,0
1613,0,0,0,0,0,0,2,0.0,2,0,0,0,0,0,0,0
1614,0,0,0,0,0,0,1,0.0,1,1,0,1,1,1,0,0
1615,2,2,1,1,0,2,3,66.7,1,0,0,0,0,2,0,0
1616,0,0,0,0,0,0,0,0.0,0,0,0,0,0,0,0,0
1617,0,0,0,0,0,0,0,0.0,0,0,0,0,0,0,0,0
1618,0,0,0,0,0,0,1,0.0,1,0,0,0,0,0,8,1
1619,49,24,25,19,5,15,36,41.7,21,53,19,34,28,77,40,1
1620,31,20,14,11,6,14,31,45.2,17,22,1,21,15,46,20,0
1621,63,40,36,20,7,22,49,44.9,27,30,16,14,31,94,45,0
1622,32,24,14,10,8,4,23,17.4,19,19,4,15,15,47,35,0
1623,50,27,21,19,10,21,36,58.3,15,30,3,27,9,59,29,0
1624,37,23,23,13,1,17,23,73.9,6,24,14,10,25,62,82,0
1625,29,15,19,9,1,16,29,55.2,13,40,26,14,16,45,93,0
1626,50,24,35,13,2,26,42,61.9,16,36,14,22,37,87,57,1
1627,17,10,5,5,7,8,20,40.0,12,21,1,20,6,23,23,0
1628,43,19,28,8,7,26,42,61.9,16,33,15,18,22,65,64,0
1629,16,12,8,5,3,2,14,14.3,12,17,4,13,9,25,27,0
1630,21,13,10,9,2,8,21,38.1,13,27,3,24,9,30,22,0
1631,20,13,14,5,1,13,23,56.5,10,18,11,7,14,34,51,0
1632,20,12,9,11,0,7,18,38.9,11,9,3,6,2,22,16,0
1633,20,15,14,5,1,10,15,66.7,5,17,8,9,12,32,44,3
1634,17,11,11,5,1,6,10,60.0,4,16,4,12,11,28,37,0
1635,9,4,6,0,3,5,11,45.5,6,8,1,7,8,17,12,0
1636,8,5,4,4,0,1,6,16.7,5,7,0,7,1,9,3,0
1637,5,1,1,2,2,1,2,50.0,1,1,0,1,0,5,2,0
1638,5,4,3,2,0,2,5,40.0,3,1,0,1,0,5,2,0
1639,1,1,1,0,0,1,2,50.0,1,5,2,3,1,2,11,1
1640,2,2,2,0,0,2,4,50.0,2,1,0,1,1,3,2,0
1641,0,0,0,0,0,0,0,0.0,0,1,0,1,0,0,0,0
1642,1,0,0,0,1,0,0,0.0,0,0,0,0,0,1,0,0
1643,37,21,18,14,5,16,25,64.0,9,45,35,10,46,83,178,2
1644,24,14,5,16,3,12,40,30.0,28,28,2,26,11,35,26,0
1645,1,0,1,0,0,1,3,33.3,2,0,0,0,0,1,17,5
1646,23,14,7,13,3,6,15,40.0,9,17,3,14,6,29,35,0
1647,35,23,13,17,5,16,25,64.0,9,44,24,20,35,70,108,0
1648,23,10,6,10,7,10,25,40.0,15,19,4,15,7,30,17,0
1649,30,19,14,13,3,18,36,50.0,18,32,7,25,20,50,20,0
1650,51,39,25,18,8,23,40,57.5,17,29,9,20,24,75,48,0
1651,64,39,31,27,6,24,44,54.5,20,20,3,17,19,83,46,0
1652,36,17,22,10,4,17,33,51.5,16,39,8,31,18,54,43,0
1653,23,11,9,8,6,14,28,50.0,14,30,1,29,12,35,21,0
1654,35,24,13,21,1,13,33,39.4,20,15,9,6,16,51,27,0
1655,33,18,15,14,4,12,29,41.4,17,23,1,22,15,48,21,0
1656,28,14,14,10,4,15,33,45.5,18,13,1,12,20,48,15,0
1657,14,9,5,8,1,5,14,35.7,9,19,2,17,6,20,11,0
1658,19,12,13,4,2,9,17,52.9,8,14,8,6,11,30,30,1
1659,20,11,11,9,0,13,21,61.9,8,15,3,12,8,28,10,0
1660,6,5,1,3,2,1,5,20.0,4,13,5,8,7,13,15,0
1661,7,5,2,1,4,2,7,28.6,5,1,0,1,0,7,4,0
1662,11,7,6,4,1,5,6,83.3,1,10,6,4,11,22,21,0
1663,0,0,0,0,0,0,2,0.0,2,8,1,7,1,1,4,0
1664,0,0,0,0,0,0,0,0.0,0,0,0,0,0,0,1,1
1665,0,0,0,0,0,0,0,0.0,0,1,0,1,0,0,3,0
1666,3,3,3,0,0,3,5,60.0,2,0,0,0,0,3,1,0
1667,4,3,0,2,2,1,3,33.3,2,2,1,1,2,6,2,0
1668,1,1,0,0,1,1,3,33.3,2,1,0,1,0,1,1,0
1669,0,0,0,0,0,0,0,0.0,0,0,0,0,0,0,2,0
1670,0,0,0,0,0,0,0,0.0,0,1,0,1,0,0,0,0
1671,0,0,0,0,0,0,0,0.0,0,0,0,0,0,0,0,0
1672,13,10,4,6,3,7,17,41.2,10,13,4,9,3,16,21,0
1673,51,31,15,27,9,28,57,49.1,29,23,4,19,24,75,60,0
1674,62,39,33,18,11,41,64,64.1,23,43,5,38,29,91,65,0
1675,48,29,28,18,2,29,41,70.7,12,35,12,23,24,72,121,0
1676,2,1,2,0,0,2,3,66.7,1,0,0,0,0,2,16,5
1677,39,18,17,22,0,12,31,38.7,19,20,1,19,12,51,13,0
1678,37,20,24,7,6,21,46,45.7,25,27,1,26,21,58,45,1
1679,34,24,21,11,2,14,21,66.7,7,29,17,12,26,60,94,0
1680,37,17,8,19,10,12,38,31.6,26,25,5,20,21,58,28,0
1681,19,9,13,4,2,10,22,45.5,12,32,21,11,15,34,88,1
1682,31,20,16,12,3,9,32,28.1,23,15,2,13,7,38,35,0
1683,26,12,19,7,0,13,19,68.4,6,21,12,9,18,44,81,0
1684,42,21,22,13,7,20,34,58.8,14,27,2,25,23,65,26,0
1685,32,15,11,11,10,15,28,53.6,13,17,6,11,14,46,29,0
1686,8,3,3,4,1,2,14,14.3,12,13,0,13,8,16,6,0
1687,5,2,3,0,2,1,6,16.7,5,13,0,13,3,8,9,0
1688,14,6,7,5,2,10,14,71.4,4,16,5,11,5,19,23,1
1689,0,0,0,0,0,0,0,0.0,0,0,0,0,0,0,4,0
1690,14,5,5,5,4,8,18,44.4,10,14,0,14,3,17,7,0
1691,2,1,0,1,1,0,2,0.0,2,9,0,9,3,5,6,0
1692,14,5,12,2,0,3,6,50.0,3,3,0,3,2,16,5,0
1693,8,6,4,3,1,2,5,40.0,3,8,1,7,1,9,12,0
1694,8,6,4,4,0,2,7,28.6,5,3,0,3,4,12,6,0
1695,3,2,1,2,0,1,2,50.0,1,6,1,5,2,5,1,0
1696,1,1,0,0,1,0,0,0.0,0,1,0,1,0,1,0,0
1697,0,0,0,0,0,0,0,0.0,0,1,0,1,0,0,0,0
1698,0,0,0,0,0,0,0,0.0,0,0,0,0,0,0,0,0
1699,0,0,0,0,0,0,0,0.0,0,0,0,0,0,0,0,0
1700,38,23,20,15,3,15,26,57.7,11,66,36,30,43,81,159,2
1701,2,2,2,0,0,2,5,40.0,3,1,0,1,1,3,19,1
1702,65,40,19,37,9,30,50,60.0,20,45,16,29,36,101,53,0
1703,56,23,30,25,1,27,44,61.4,17,43,7,36,32,88,45,0
1704,65,42,36,25,4,36,57,63.2,21,27,6,21,43,108,58,0
1705,33,20,11,16,6,13,39,33.3,26,22,2,20,27,60,23,0
1706,34,15,15,16,3,16,33,48.5,17,27,3,24,17,51,47,0
1707,22,14,5,11,6,14,24,58.3,10,15,0,15,5,27,4,0
1708,12,8,2,6,4,4,11,36.4,7,16,3,13,3,15,2,0
1709,17,8,4,6,7,6,11,54.5,5,18,4,14,2,19,7,0
1710,3,2,1,2,0,2,11,18.2,9,6,2,4,4,7,11,0
1711,22,14,8,10,4,13,19,68.4,6,16,2,14,14,36,18,0
1712,57,33,22,31,4,21,58,36.2,37,33,4,29,17,74,28,0
1713,25,16,15,9,1,16,24,66.7,8,14,6,8,22,47,52,0
1714,23,10,12,8,3,17,28,60.7,11,18,5,13,16,39,37,0
1715,20,12,10,8,2,10,16,62.5,6,10,4,6,11,31,41,0
1716,18,9,9,7,2,9,19,47.4,10,17,4,13,16,34,24,0
1717,8,8,7,1,0,4,8,50.0,4,7,5,2,6,14,30,0
1718,10,4,5,3,2,4,11,36.4,7,9,0,9,2,12,1,0
1719,15,10,10,5,0,6,7,85.7,1,13,7,6,13,28,21,0
1720,6,3,5,1,0,3,6,50.0,3,2,0,2,4,10,13,0
1721,0,0,0,0,0,0,0,0.0,0,0,0,0,0,0,3,0
1722,5,4,2,3,0,0,4,0.0,4,1,0,1,4,9,2,0
1723,1,1,0,1,0,0,0,0.0,0,3,1,2,3,4,0,0
1724,3,0,2,0,1,2,4,50.0,2,5,0,5,2,5,5,0
1725,9,5,2,6,1,3,6,50.0,3,7,0,7,2,11,1,0
1726,2,1,2,0,0,2,3,66.7,1,1,0,1,1,3,0,0
1727,0,0,0,0,0,0,1,0.0,1,0,0,0,0,0,0,0
1728,0,0,0,0,0,0,0,0.0,0,0,0,0,0,0,0,0
1729,1,1,0,1,0,1,1,100.0,0,0,0,0,0,1,0,0
1730,66,40,28,32,6,41,67,61.2,26,47,14,33,48,114,61,1
1731,33,18,22,10,1,18,24,75.0,6,40,25,15,43,76,150,2
1732,25,13,13,10,2,11,20,55.0,9,22,3,19,9,34,35,1
1733,1,0,1,0,0,1,3,33.3,2,0,0,0,0,1,12,5
1734,41,28,21,17,3,23,40,57.5,17,31,11,20,18,59,78,2
1735,38,22,19,16,3,23,43,53.5,20,36,10,26,22,60,76,1
1736,61,36,28,29,4,28,55,50.9,27,61,20,41,44,105,31,1
1737,66,31,40,25,1,31,53,58.5,22,47,26,21,38,104,111,0
1738,17,7,5,8,4,7,15,46.7,8,11,0,11,2,19,6,0
1739,34,21,17,15,2,16,26,61.5,10,32,18,14,22,56,62,0
1740,45,26,20,20,5,17,25,68.0,8,22,1,21,15,60,16,1
1741,10,4,0,8,2,3,8,37.5,5,12,3,9,5,15,28,0
1742,23,15,16,6,1,12,20,60.0,8,28,20,8,17,40,87,0
1743,15,12,7,8,0,8,26,30.8,18,8,6,2,14,29,8,0
1744,37,22,17,18,2,16,34,47.1,18,22,0,22,5,42,17,1
1745,15,8,6,7,2,4,17,23.5,13,16,0,16,14,29,21,0
1746,23,16,15,8,0,14,24,58.3,10,13,6,7,5,28,28,0
1747,4,3,0,2,2,1,3,33.3,2,5,1,4,2,6,8,0
1748,1,0,1,0,0,1,1,100.0,0,0,0,0,0,1,3,0
1749,10,5,5,5,0,2,14,14.3,12,7,1,6,4,14,6,0
1750,8,5,5,1,2,5,7,71.4,2,2,1,1,3,11,9,0
1751,4,4,2,1,1,2,2,100.0,0,1,0,1,1,5,2,0
1752,1,0,0,0,1,0,0,0.0,0,0,0,0,0,1,0,0
1753,1,0,1,0,0,1,4,25.0,3,0,0,0,0,1,1,0
1754,2,0,1,1,0,1,2,50.0,1,0,0,0,1,3,0,0
1755,1,1,1,0,0,1,1,100.0,0,2,2,0,1,2,4,0
1756,0,0,0,0,0,0,0,0.0,0,0,0,0,0,0,0,0
1757,1,1,1,0,0,0,0,0.0,0,0,0,0,1,2,20,2
1758,52,36,31,15,6,25,51,49.0,26,48,22,26,47,99,155,1
1759,63,44,25,31,7,30,44,68.2,14,52,9,43,36,99,75,0
1760,34,23,18,16,0,15,21,71.4,6,46,25,21,38,72,111,1
1761,34,22,27,7,0,19,30,63.3,11,27,19,8,13,47,73,0
1762,23,15,12,10,1,13,33,39.4,20,16,3,13,13,36,57,0
1763,35,20,14,17,4,17,37,45.9,20,32,9,23,25,60,41,0
1764,35,22,15,19,1,17,26,65.4,9,12,5,7,22,57,38,0
1765,22,9,8,8,6,8,20,40.0,12,8,0,8,6,28,12,0
1766,10,9,6,4,0,6,12,50.0,6,22,15,7,7,17,72,2
1767,17,11,5,7,5,7,22,31.8,15,28,0,28,4,21,3,0
1768,20,14,11,7,2,10,21,47.6,11,17,3,14,12,32,27,1
1769,32,18,13,13,6,16,32,50.0,16,26,1,25,2,34,4,0
1770,13,10,3,7,3,1,4,25.0,3,7,2,5,6,19,19,0
1771,36,24,16,13,7,22,45,48.9,23,21,4,17,12,48,18,0
1772,29,16,9,15,5,11,20,55.0,9,25,4,21,20,49,25,0
1773,19,14,7,10,2,8,20,40.0,12,15,4,11,11,30,30,0
1774,21,12,4,12,5,4,12,33.3,8,26,2,24,12,33,14,2
1775,16,9,6,7,3,8,12,66.7,4,13,4,9,5,21,26,0
1776,10,7,3,5,2,4,9,44.4,5,4,0,4,0,10,5,0
1777,3,3,0,2,1,0,2,0.0,2,2,0,2,0,3,2,0
1778,3,2,0,3,0,1,4,25.0,3,8,0,8,1,4,3,0
1779,6,5,2,4,0,4,4,100.0,0,5,3,2,7,13,16,0
1780,6,3,2,3,1,3,10,30.0,7,12,0,12,1,7,4,0
1781,7,2,4,3,0,5,9,55.6,4,3,2,1,4,11,7,0
1782,0,0,0,0,0,0,0,0.0,0,0,0,0,0,0,2,0
1783,2,1,0,2,0,0,1,0.0,1,3,0,3,0,2,2,0
1784,0,0,0,0,0,0,3,0.0,3,1,0,1,0,0,0,0
1785,0,0,0,0,0,0,0,0.0,0,1,1,0,0,0,0,0
1786,0,0,0,0,0,0,0,0.0,0,0,0,0,0,0,0,0
1787,2,1,2,0,0,2,4,50.0,2,0,0,0,1,3,25,1
1788,99,58,56,35,8,45,69,65.2,24,66,30,36,55,154,120,1
1789,49,30,21,21,7,25,63,39.7,38,46,4,42,19,68,18,0
1790,63,37,15,40,8,23,51,45.1,28,37,8,29,25,88,51,0
1791,17,6,2,9,6,7,23,30.4,16,17,3,14,4,21,11,0
1792,64,40,37,22,5,37,70,52.9,33,32,10,22,25,89,75,2
1793,42,22,26,14,2,25,30,83.3,5,33,23,10,33,75,104,2
1794,19,14,11,6,2,10,17,58.8,7,41,29,12,31,50,130,0
1795,38,26,14,23,1,17,36,47.2,19,36,9,27,27,65,32,1
1796,32,22,13,12,7,13,32,40.6,19,24,3,21,12,44,26,0
1797,10,5,4,5,1,4,7,57.1,3,11,2,9,4,14,17,0
1798,11,7,2,5,4,2,8,25.0,6,11,2,9,0,11,6,0
1799,23,17,9,11,3,13,21,61.9,8,12,1,11,18,41,23,0
1800,21,14,9,10,2,14,24,58.3,10,13,2,11,10,31,21,0
1801,24,18,12,11,1,14,33,42.4,19,20,7,13,15,39,34,1
1802,21,12,10,6,5,12,22,54.5,10,13,2,11,2,23,11,1
1803,19,11,11,4,4,9,14,64.3,5,15,6,9,2,21,22,0
1804,8,4,2,2,4,3,6,50.0,3,5,0,5,0,8,7,0
1805,9,4,2,3,4,4,9,44.4,5,7,0,7,2,11,2,0
1806,9,5,3,4,2,2,6,33.3,4,3,0,3,7,16,3,0
1807,10,6,5,3,2,5,8,62.5,3,6,0,6,7,17,11,0
1808,10,7,6,4,0,7,14,50.0,7,7,1,6,7,17,18,0
1809,3,0,0,3,0,1,7,14.3,6,4,0,4,2,5,0,0
1810,0,0,0,0,0,0,0,0.0,0,0,0,0,0,0,1,0
1811,0,0,0,0,0,0,0,0.0,0,1,0,1,0,0,0,0
1812,1,0,1,0,0,1,1,100.0,0,0,0,0,0,1,10,1
1813,59,42,40,17,2,35,59,59.3,24,66,43,23,45,104,145,0
1814,68,47,51,14,3,49,80,61.3,31,54,28,26,63,131,168,1
1815,70,43,32,34,4,37,67,55.2,30,65,19,46,43,113,80,0
1816,28,20,8,13,7,17,39,43.6,22,20,6,14,13,41,23,1
1817,43,27,20,18,5,20,43,46.5,23,22,2,20,18,61,11,0
1818,18,15,11,5,2,9,28,32.1,19,12,1,11,6,24,12,0
1819,28,18,13,9,6,12,24,50.0,12,31,6,25,8,36,28,0
1820,65,39,40,25,0,39,74,52.7,35,35,10,25,22,87,39,0
1821,47,22,23,20,4,31,56,55.4,25,38,9,29,20,67,50,2
1822,38,18,17,15,6,20,31,64.5,11,26,1,25,13,51,14,0
1823,4,2,1,3,0,0,2,0.0,2,5,3,2,0,4,20,0
1824,10,4,3,6,1,4,18,22.2,14,23,2,21,8,18,15,1
1825,19,12,4,12,3,5,16,31.3,11,18,3,15,6,25,8,1
1826,27,15,20,7,0,17,34,50.0,17,19,4,15,7,34,29,0
1827,21,11,9,9,3,11,22,50.0,11,17,5,12,10,31,30,1
1828,14,9,2,9,3,6,11,54.5,5,16,1,15,5,19,7,0
1829,10,6,4,5,1,3,7,42.9,4,4,2,2,1,11,12,0
1830,16,9,15,1,0,9,14,64.3,5,12,5,7,7,23,28,0
1831,12,5,6,6,0,8,12,66.7,4,6,1,5,3,15,28,0
1832,8,4,2,3,3,4,12,33.3,8,6,0,6,1,9,2,0
1833,10,6,7,3,0,4,7,57.1,3,8,2,6,4,14,4,0
1834,0,0,0,0,0,0,0,0.0,0,1,1,0,0,0,0,1
1835,1,1,1,0,0,1,2,50.0,1,1,0,1,0,1,1,0
1836,0,0,0,0,0,0,0,0.0,0,0,0,0,2,2,2,0
1837,0,0,0,0,0,0,0,0.0,0,1,0,1,0,0,0,0
1838,1,0,1,0,0,1,3,33.3,2,0,0,0,2,3,11,4
1839,26,16,12,10,4,10,28,35.7,18,25,2,23,6,32,20,0
1840,37,22,30,4,3,24,36,66.7,12,31,20,11,21,58,94,1
1841,47,26,18,21,8,20,37,54.1,17,22,12,10,24,71,29,0
1842,51,25,32,11,8,33,65,50.8,32,22,4,18,25,76,20,0
1843,35,21,25,10,0,22,36,61.1,14,29,11,18,22,57,92,5
1844,11,6,2,6,3,5,11,45.5,6,5,1,4,2,13,21,0
1845,28,21,10,14,4,11,27,40.7,16,21,2,19,33,61,15,0
1846,45,27,23,14,8,21,33,63.6,12,42,11,31,13,58,43,0
1847,29,22,22,6,1,22,41,53.7,19,11,1,10,17,46,26,0
1848,44,22,18,25,1,17,30,56.7,13,26,14,12,19,63,42,2
1849,13,6,3,7,3,7,10,70.0,3,15,5,10,3,16,19,0
1850,20,13,9,8,3,8,24,33.3,16,16,4,12,9,29,12,0
1851,15,12,4,10,1,7,28,25.0,21,12,4,8,30,45,29,2
1852,33,21,26,7,0,19,39,48.7,20,21,14,7,21,54,66,1
1853,33,16,21,9,3,16,27,59.3,11,24,12,12,17,50,39,1
1854,10,4,2,7,1,3,17,17.6,14,12,2,10,11,21,6,1
1855,14,7,7,6,1,6,20,30.0,14,14,2,12,8,22,25,0
1856,22,13,16,5,1,15,24,62.5,9,11,3,8,11,33,26,0
1857,11,5,7,3,1,5,9,55.6,4,10,7,3,10,21,34,0
1858,3,2,0,2,1,0,3,0.0,3,8,2,6,1,4,9,0
1859,1,0,1,0,0,0,1,0.0,1,5,1,4,0,1,4,0
1860,0,0,0,0,0,0,2,0.0,2,0,0,0,0,0,2,1
1861,2,0,0,1,1,0,0,0.0,0,1,0,1,0,2,0,0
1862,8,5,3,4,1,7,10,70.0,3,7,0,7,2,10,4,1
1863,14,9,8,5,1,4,9,44.4,5,5,2,3,4,18,5,0
1864,4,1,2,1,1,1,3,33.3,2,1,0,1,4,8,5,0
1865,0,0,0,0,0,0,1,0.0,1,2,1,1,0,0,4,0
1866,1,0,1,0,0,1,8,12.5,7,1,0,1,1,2,1,0
1867,1,1,0,0,1,0,0,0.0,0,0,0,0,0,1,1,0
1868,1,0,0,1,0,0,1,0.0,1,1,0,1,1,2,3,0
1869,29,17,5,13,11,10,22,45.5,12,29,7,22,3,32,29,0
1870,0,0,0,0,0,0,3,0.0,3,0,0,0,0,0,6,4
1871,41,26,23,13,5,23,39,59.0,16,32,16,16,66,107,119,3
1872,33,23,13,10,10,8,22,36.4,14,27,1,26,9,42,4,0
1873,51,31,21,22,8,31,49,63.3,18,34,2,32,16,67,36,0
1874,48,31,25,22,1,23,34,67.6,11,38,27,11,30,78,98,2
1875,54,32,17,29,8,25,37,67.6,12,26,6,20,43,97,30,1
1876,68,45,35,24,9,38,77,49.4,39,30,4,26,20,88,33,1
1877,33,21,18,14,1,18,29,62.1,11,23,3,20,11,44,28,1
1878,19,10,7,8,4,8,23,34.8,15,15,5,10,11,30,13,0
1879,39,23,17,15,7,16,36,44.4,20,39,4,35,15,54,10,0
1880,24,14,8,12,4,7,20,35.0,13,17,1,16,15,39,4,0
1881,31,20,13,11,7,13,28,46.4,15,14,3,11,10,41,10,0
1882,22,17,13,6,3,13,20,65.0,7,4,1,3,15,37,9,0
1883,18,12,8,7,3,12,19,63.2,7,9,2,7,7,25,17,0
1884,3,1,0,2,1,1,5,20.0,4,6,0,6,1,4,3,0
1885,5,4,3,0,2,5,12,41.7,7,3,1,2,1,6,6,0
1886,8,3,2,3,3,3,5,60.0,2,3,0,3,1,9,1,0
1887,2,0,1,1,0,2,2,100.0,0,2,0,2,2,4,2,0
1888,1,0,0,0,1,0,2,0.0,2,1,0,1,2,3,5,0
1889,9,3,0,4,5,1,3,33.3,2,1,0,1,1,10,2,0
1890,3,3,1,1,1,3,4,75.0,1,3,1,2,5,8,5,0
1891,3,2,3,0,0,1,1,100.0,0,4,2,2,1,4,5,0
1892,0,0,0,0,0,0,0,0.0,0,0,0,0,0,0,1,0
1893,2,2,0,2,0,0,0,0.0,0,0,0,0,0,2,0,0
1894,0,0,0,0,0,0,0,0.0,0,0,0,0,0,0,0,0
1895,0,0,0,0,0,0,0,0.0,0,0,0,0,0,0,0,0
1896,0,0,0,0,0,0,0,0.0,0,0,0,0,0,0,0,0
1897,0,0,0,0,0,0,0,0.0,0,0,0,0,0,0,0,0
1898,49,31,29,15,5,23,34,67.6,11,18,4,14,31,80,49,2
1899,38,27,22,13,3,23,40,57.5,17,29,24,5,29,67,94,0
1900,66,42,17,29,20,24,39,61.5,15,32,5,27,13,79,16,0
1901,83,44,26,45,12,50,90,55.6,40,68,16,52,50,133,38,0
1902,8,1,1,4,3,2,9,22.2,7,19,2,17,0,8,9,0
1903,31,17,4,19,8,9,26,34.6,17,18,0,18,3,34,10,0
1904,45,25,20,17,8,19,42,45.2,23,21,1,20,28,73,22,0
1905,22,15,5,10,7,10,27,37.0,17,20,0,20,9,31,18,1
1906,1,1,1,0,0,1,2,50.0,1,0,0,0,0,1,8,0
1907,0,0,0,0,0,0,2,0.0,2,0,0,0,0,0,8,4
1908,46,30,18,15,13,11,30,36.7,19,19,2,17,3,49,14,0
1909,27,20,19,7,1,18,25,72.0,7,6,2,4,20,47,50,1
1910,39,24,17,18,4,18,29,62.1,11,27,6,21,17,56,24,0
1911,25,10,19,6,0,12,13,92.3,1,14,7,7,16,41,41,0
1912,20,16,5,8,7,8,23,34.8,15,9,0,9,4,24,11,0
1913,15,7,7,7,1,7,20,35.0,13,15,2,13,16,31,25,0
1914,7,4,0,5,2,0,4,0.0,4,7,1,6,0,7,11,0
1915,6,3,4,2,0,2,5,40.0,3,5,3,2,2,8,6,0
1916,23,13,9,7,7,12,17,70.6,5,6,0,6,5,28,7,0
1917,7,5,3,2,2,4,6,66.7,2,3,1,2,4,11,0,0
1918,8,5,6,0,2,4,5,80.0,1,5,0,5,2,10,2,0
1919,4,2,2,2,0,1,1,100.0,0,3,1,2,1,5,2,0
1920,4,1,1,3,0,1,4,25.0,3,4,0,4,1,5,1,0
1921,3,1,1,2,0,0,5,0.0,5,3,0,3,1,4,0,0
1922,3,0,1,2,0,3,4,75.0,1,1,0,1,0,3,1,0
1923,45,30,18,23,4,20,44,45.5,24,34,16,18,32,77,90,1
1924,59,38,20,24,15,35,85,41.2,50,30,1,29,17,76,20,0
1925,0,0,0,0,0,0,0,0.0,0,0,0,0,0,0,12,1
1926,29,17,13,11,5,18,51,35.3,33,18,2,16,10,39,10,0
1927,49,21,18,25,6,20,57,35.1,37,46,9,37,28,77,37,0
1928,29,19,9,15,5,18,29,62.1,11,19,3,16,28,57,32,0
1929,52,32,32,19,1,33,56,58.9,23,27,8,19,26,78,51,1
1930,34,19,14,13,7,22,46,47.8,24,27,3,24,16,50,35,0
1931,17,14,5,10,2,9,23,39.1,14,13,0,13,16,33,13,0
1932,41,23,20,16,5,23,37,62.2,14,19,2,17,14,55,38,2
1933,36,20,25,7,4,30,55,54.5,25,20,5,15,30,66,41,0
1934,24,14,6,10,8,3,12,25.0,9,28,1,27,9,33,18,0
1935,14,10,2,6,6,2,12,16.7,10,13,1,12,1,15,6,0
1936,31,19,15,11,5,19,34,55.9,15,11,0,11,12,43,11,1
1937,21,9,7,11,3,11,22,50.0,11,5,1,4,8,29,20,0
1938,8,6,4,3,1,4,8,50.0,4,6,3,3,7,15,21,1
1939,6,4,6,0,0,4,7,57.1,3,12,8,4,4,10,40,2
1940,6,5,3,0,3,3,8,37.5,5,9,1,8,4,10,7,0
1941,9,4,0,5,4,3,8,37.5,5,11,1,10,2,11,4,0
1942,12,8,3,7,2,8,18,44.4,10,6,0,6,1,13,3,0
1943,1,1,0,1,0,0,2,0.0,2,3,0,3,0,1,2,0
1944,0,0,0,0,0,0,0,0.0,0,0,0,0,0,0,0,0
1945,0,0,0,0,0,0,1,0.0,1,1,0,1,2,2,2,0
1946,9,6,4,2,3,5,6,83.3,1,2,0,2,1,10,1,0
1947,6,2,2,2,2,3,3,100.0,0,0,0,0,1,7,0,0
1948,3,2,3,0,0,1,1,100.0,0,1,0,1,0,3,3,0
1949,35,18,5,20,10,17,30,56.7,13,26,6,20,3,38,31,0
1950,34,25,17,15,2,25,41,61.0,16,31,11,20,18,52,59,1
1951,0,0,0,0,0,0,0,0.0,0,0,0,0,0,0,6,0
1952,46,25,8,26,12,19,46,41.3,27,33,6,27,16,62,30,0
1953,19,16,15,3,1,9,13,69.2,4,18,14,4,21,40,49,4
1954,44,25,26,11,7,21,38,55.3,17,26,9,17,30,74,43,0
1955,44,26,16,19,9,20,46,43.5,26,46,5,41,25,69,40,0
1956,63,32,24,34,5,28,54,51.9,26,22,4,18,43,106,35,0
1957,35,21,10,18,7,17,33,51.5,16,11,0,11,10,45,12,0
1958,13,7,10,2,1,11,16,68.8,5,19,14,5,20,33,76,0
1959,29,19,9,13,7,14,34,41.2,20,18,1,17,9,38,5,0
1960,17,12,12,4,1,11,17,64.7,6,17,14,3,12,29,46,0
1961,41,28,17,22,2,18,34,52.9,16,30,5,25,18,59,16,0
1962,11,6,4,7,0,8,14,57.1,6,11,0,11,2,13,2,0
1963,9,4,6,3,0,3,4,75.0,1,14,10,4,7,16,25,1
1964,14,8,4,6,4,7,16,43.8,9,5,3,2,3,17,5,0
1965,11,7,4,4,3,4,13,30.8,9,6,1,5,5,16,8,0
1966,16,12,7,7,2,8,10,80.0,2,14,1,13,4,20,7,0
1967,12,4,3,5,4,5,9,55.6,4,7,1,6,1,13,4,0
1968,10,7,4,5,1,3,6,50.0,3,5,3,2,3,13,16,0
1969,0,0,0,0,0,0,0,0.0,0,0,0,0,0,0,1,0
1970,14,11,7,4,3,8,16,50.0,8,9,2,7,9,23,12,0
1971,9,6,3,5,1,4,7,57.1,3,2,0,2,3,12,1,0
1972,9,7,6,1,2,6,11,54.5,5,3,0,3,0,9,2,0
1973,2,1,2,0,0,1,1,100.0,0,1,0,1,1,3,6,0
1974,8,2,2,6,0,4,11,36.4,7,1,0,1,1,9,2,0
1975,0,0,0,0,0,0,0,0.0,0,0,0,0,0,0,1,0
1976,1,0,0,1,0,1,4,25.0,3,0,0,0,1,2,0,0
1977,4,2,2,2,0,4,4,100.0,0,0,0,0,3,7,4,0
1978,0,0,0,0,0,0,0,0.0,0,0,0,0,0,0,2,0
1979,0,0,0,0,0,0,0,0.0,0,0,0,0,0,0,1,0
1980,0,0,0,0,0,0,0,0.0,0,0,0,0,0,0,1,0
1981,3,2,2,1,0,3,4,75.0,1,0,0,0,1,4,1,0
1982,67,38,36,24,7,31,52,59.6,21,50,22,28,45,112,84,0
1983,43,27,14,20,9,11,28,39.3,17,40,9,31,26,69,29,0
1984,7,4,0,2,5,2,4,50.0,2,16,1,15,0,7,25,0
1985,43,29,23,15,5,27,37,73.0,10,21,6,15,31,74,51,0
1986,17,12,7,6,4,9,21,42.9,12,12,1,11,4,21,7,0
1987,29,12,20,9,0,13,22,59.1,9,24,15,9,40,69,86,0
1988,20,13,5,10,5,7,29,24.1,22,13,2,11,5,25,16,0
1989,0,0,0,0,0,0,2,0.0,2,0,0,0,0,0,7,3
1990,34,24,10,21,3,17,36,47.2,19,23,7,16,26,60,20,0
1991,26,15,14,8,4,12,22,54.5,10,14,0,14,5,31,11,0
1992,24,13,12,8,4,10,18,55.6,8,13,4,9,20,44,24,1
1993,11,7,5,5,1,6,11,54.5,5,7,4,3,9,20,17,0
1994,21,11,6,12,3,11,24,45.8,13,20,4,16,8,29,8,2
1995,20,14,10,10,0,12,20,60.0,8,16,8,8,9,29,35,0
1996,22,14,13,6,3,20,30,66.7,10,13,3,10,16,38,19,0
1997,13,2,3,8,2,8,14,57.1,6,19,4,15,5,18,9,0
1998,15,8,2,10,3,4,8,50.0,4,9,0,9,3,18,13,0
1999,19,12,8,7,4,10,19,52.6,9,14,1,13,2,21,7,0
2000,25,12,13,8,4,14,28,50.0,14,9,1,8,11,36,16,0
2001,0,0,0,0,0,0,2,0.0,2,1,0,1,0,0,4,1
2002,10,5,2,5,3,3,8,37.5,5,6,0,6,1,11,3,0
2003,0,0,0,0,0,0,0,0.0,0,0,0,0,0,0,4,1
2004,28,17,12,9,7,20,24,83.3,4,5,0,5,4,32,14,1
2005,15,10,10,5,0,14,27,51.9,13,7,1,6,3,18,12,0
2006,5,5,2,3,0,3,8,37.5,5,8,4,4,12,17,2,0
2007,3,2,2,1,0,1,3,33.3,2,4,3,1,2,5,8,1
2008,1,0,1,0,0,0,3,0.0,3,1,0,1,0,1,2,0
2009,4,3,2,2,0,4,11,36.4,7,4,1,3,1,5,5,1
2010,2,2,1,0,1,0,3,0.0,3,4,0,4,1,3,3,0
2011,3,2,1,1,1,1,4,25.0,3,0,0,0,0,3,1,0
2012,1,0,0,0,1,0,1,0.0,1,2,0,2,1,2,0,0
2013,2,1,0,0,2,0,2,0.0,2,0,0,0,1,3,0,0
2014,0,0,0,0,0,0,1,0.0,1,0,0,0,1,1,0,0
2015,2,1,2,0,0,1,2,50.0,1,0,0,0,1,3,0,0
2016,1,1,0,1,0,0,2,0.0,2,0,0,0,0,1,0,0
2017,109,71,70,29,10,55,86,64.0,31,52,17,35,39,148,123,3
2018,0,0,0,0,0,0,4,0.0,4,1,0,1,0,0,7,2
2019,31,21,17,9,5,17,28,60.7,11,66,50,16,27,58,136,1
2020,48,24,26,21,1,21,44,47.7,23,29,11,18,28,76,59,0
2021,15,12,4,9,2,4,19,21.1,15,12,3,9,5,20,22,0
2022,30,16,9,12,9,11,26,42.3,15,21,0,21,6,36,15,0
2023,47,23,32,14,1,28,55,50.9,27,33,6,27,12,59,54,1
2024,44,35,22,18,4,25,59,42.4,34,36,11,25,30,74,38,1
2025,24,14,16,8,0,9,11,81.8,2,26,21,5,17,41,89,1
2026,37,18,15,11,11,9,37,24.3,28,26,3,23,14,51,17,0
2027,66,40,46,16,4,42,78,53.8,36,33,7,26,14,80,27,1
2028,33,17,14,15,4,19,37,51.4,18,29,5,24,20,53,26,0
2029,25,14,14,8,3,9,29,31.0,20,15,1,14,4,29,11,0
2030,14,7,7,4,3,9,20,45.0,11,9,3,6,13,27,35,0
2031,8,6,4,4,0,4,12,33.3,8,8,3,5,4,12,2,0
2032,37,24,32,5,0,20,33,60.6,13,17,6,11,14,51,24,1
2033,14,8,9,5,0,5,13,38.5,8,12,7,5,11,25,89,2
2034,23,17,11,10,2,13,31,41.9,18,11,1,10,4,27,10,0
2035,2,0,1,0,1,0,2,0.0,2,0,0,0,1,3,7,0
2036,4,2,1,1,2,1,3,33.3,2,2,1,1,1,5,1,0
2037,0,0,0,0,0,0,0,0.0,0,0,0,0,0,0,2,0
2038,4,3,1,2,1,2,4,50.0,2,3,1,2,0,4,5,0
2039,2,1,0,0,2,0,4,0.0,4,5,0,5,0,2,1,0
2040,4,3,2,1,1,3,6,50.0,3,5,2,3,4,8,7,0
2041,0,0,0,0,0,0,1,0.0,1,0,0,0,0,0,0,0
2042,0,0,0,0,0,0,0,0.0,0,0,0,0,0,0,0,0
2043,1,0,0,1,0,1,2,50.0,1,0,0,0,0,1,5,0
2044,0,0,0,0,0,0,2,0.0,2,0,0,0,0,0,1,0
2045,44,26,25,16,3,27,56,48.2,29,35,11,24,39,83,118,1
2046,2,2,2,0,0,2,4,50.0,2,0,0,0,0,2,9,1
2047,67,50,35,26,6,33,53,62.3,20,22,7,15,17,84,59,0
2048,40,27,10,24,6,13,36,36.1,23,20,8,12,17,57,35,1
2049,34,24,18,9,7,14,24,58.3,10,35,13,22,23,57,76,1
2050,32,15,24,5,3,23,31,74.2,8,29,18,11,13,45,93,1
2051,20,12,9,9,2,13,40,32.5,27,19,1,18,19,39,9,1
2052,55,36,17,32,6,30,58,51.7,28,28,6,22,25,80,34,0
2053,42,24,20,18,4,15,36,41.7,21,25,1,24,14,56,20,0
2054,27,18,18,9,0,18,29,62.1,11,16,5,11,14,41,70,0
2055,25,16,3,14,8,6,16,37.5,10,19,3,16,4,29,4,0
2056,35,19,15,18,2,11,27,40.7,16,11,3,8,6,41,12,0
2057,11,5,4,4,3,4,12,33.3,8,7,2,5,7,18,7,0
2058,9,5,4,4,1,5,15,33.3,10,5,1,4,5,14,11,0
2059,8,5,1,2,5,1,3,33.3,2,7,0,7,1,9,8,0
2060,23,13,12,10,1,13,15,86.7,2,12,8,4,8,31,62,1
2061,17,12,8,5,4,11,25,44.0,14,21,0,21,6,23,9,0
2062,13,5,8,3,2,4,14,28.6,10,9,3,6,5,18,30,0
2063,14,7,8,5,1,10,18,55.6,8,4,1,3,7,21,22,0
2064,0,0,0,0,0,0,0,0.0,0,0,0,0,0,0,3,1
2065,6,3,5,0,1,4,6,66.7,2,3,0,3,3,9,2,0
2066,16,10,11,4,1,11,19,57.9,8,3,1,2,3,19,8,1
2067,4,2,2,2,0,0,3,0.0,3,2,0,2,2,6,2,0
2068,1,1,0,1,0,0,4,0.0,4,5,2,3,3,4,3,0
2069,5,4,5,0,0,4,5,80.0,1,8,5,3,1,6,10,0
2070,3,3,0,1,2,1,4,25.0,3,4,0,4,1,4,1,0
2071,6,3,2,3,1,3,7,42.9,4,7,1,6,3,9,4,0
2072,1,1,0,1,0,1,4,25.0,3,1,0,1,0,1,0,0
2073,7,7,4,2,1,5,6,83.3,1,0,0,0,0,7,3,0
2074,1,0,1,0,0,0,1,0.0,1,3,0,3,0,1,1,0
2075,0,0,0,0,0,0,0,0.0,0,0,0,0,0,0,0,0
2076,2,1,2,0,0,2,3,66.7,1,1,1,0,0,2,1,0
2077,3,3,2,1,0,3,3,100.0,0,1,0,1,0,3,0,0
2078,0,0,0,0,0,0,0,0.0,0,0,0,0,0,0,0,0
2079,0,0,0,0,0,0,0,0.0,0,0,0,0,0,0,0,0
2080,2,1,2,0,0,2,2,100.0,0,1,0,1,0,2,11,4
2081,86,63,51,30,5,55,88,62.5,33,43,13,30,28,114,81,1
2082,12,4,3,5,4,5,15,33.3,10,21,3,18,3,15,38,0
2083,57,36,36,17,4,23,57,40.4,34,46,18,28,35,92,85,2
2084,53,35,23,23,7,14,37,37.8,23,28,4,24,18,71,23,1
2085,25,18,18,6,1,15,23,65.2,8,29,17,12,30,55,124,2
2086,19,9,9,10,0,10,30,33.3,20,32,13,19,24,43,41,0
2087,33,19,13,17,3,17,40,42.5,23,30,16,14,6,39,29,3
2088,35,17,16,14,5,18,45,40.0,27,29,12,17,18,53,46,0
2089,16,11,8,4,4,10,21,47.6,11,14,3,11,5,21,20,0
2090,26,18,17,8,1,16,20,80.0,4,16,7,9,6,32,103,0
2091,17,10,6,9,2,10,15,66.7,5,30,24,6,22,39,82,1
2092,14,9,6,6,2,8,16,50.0,8,3,2,1,7,21,11,0
2093,25,14,11,13,1,17,29,58.6,12,16,1,15,9,34,15,0
2094,51,34,25,22,4,20,38,52.6,18,18,4,14,20,71,29,0
2095,16,12,11,2,3,4,10,40.0,6,6,0,6,4,20,18,1
2096,19,13,9,7,3,14,24,58.3,10,10,1,9,12,31,29,0
2097,10,5,7,2,1,8,11,72.7,3,19,16,3,10,20,52,1
2098,3,1,3,0,0,3,4,75.0,1,3,1,2,2,5,5,0
2099,4,3,2,1,1,2,10,20.0,8,2,0,2,0,4,0,0
2100,2,0,2,0,0,0,1,0.0,1,1,0,1,0,2,2,0
2101,3,3,2,0,1,1,3,33.3,2,2,1,1,0,3,3,0
2102,2,2,1,1,0,2,3,66.7,1,1,0,1,0,2,0,0
2103,1,1,0,1,0,0,0,0.0,0,0,0,0,0,1,0,0
2104,0,0,0,0,0,0,0,0.0,0,0,0,0,0,0,0,0
2105,1,1,1,0,0,1,1,100.0,0,0,0,0,0,1,0,0
2106,0,0,0,0,0,0,0,0.0,0,0,0,0,0,0,7,2
2107,47,28,24,17,6,31,55,56.4,24,34,15,19,31,78,90,0
2108,54,40,21,27,6,31,56,55.4,25,25,7,18,18,72,105,0
2109,32,17,7,18,7,6,18,33.3,12,25,6,19,12,44,44,0
2110,39,19,16,18,5,21,41,51.2,20,37,17,20,36,75,79,0
2111,30,12,9,15,6,15,48,31.3,33,26,2,24,18,48,28,0
2112,37,25,25,12,0,20,29,69.0,9,48,35,13,26,63,174,1
2113,18,11,6,9,3,8,27,29.6,19,18,2,16,4,22,12,0
2114,5,4,1,2,2,0,8,0.0,8,10,1,9,2,7,12,0
2115,31,19,25,6,0,13,20,65.0,7,29,26,3,17,48,51,1
2116,30,17,13,14,3,11,26,42.3,15,10,5,5,25,55,17,0
2117,15,7,6,8,1,10,16,62.5,6,33,27,6,15,30,102,1
2118,27,17,13,7,7,16,35,45.7,19,28,3,25,10,37,16,0
2119,51,32,21,22,8,28,41,68.3,13,32,8,24,13,64,31,0
2120,16,7,4,6,6,8,19,42.1,11,14,0,14,4,20,10,0
2121,29,15,15,7,7,13,22,59.1,9,20,5,15,18,47,20,0
2122,11,7,4,2,5,4,4,100.0,0,0,0,0,1,12,2,0
2123,9,8,2,5,2,4,9,44.4,5,2,1,1,1,10,3,0
2124,6,3,2,3,1,3,6,50.0,3,2,0,2,2,8,3,0
2125,7,2,6,1,0,2,8,25.0,6,4,1,3,9,16,6,0
2126,3,2,3,0,0,3,3,100.0,0,3,0,3,2,5,4,0
2127,5,5,3,2,0,4,5,80.0,1,1,1,0,0,5,5,0
2128,0,0,0,0,0,0,1,0.0,1,0,0,0,0,0,0,0
2129,36,19,22,12,2,24,36,66.7,12,37,24,13,32,68,105,2
2130,59,41,39,14,6,35,63,55.6,28,25,6,19,25,84,72,0
2131,92,62,46,31,15,37,85,43.5,48,63,6,57,42,134,24,0
2132,64,35,26,34,4,33,62,53.2,29,30,8,22,27,91,43,0
2133,56,33,34,14,8,38,51,74.5,13,34,5,29,20,76,51,0
2134,36,17,27,7,2,17,29,58.6,12,28,19,9,49,85,120,0
2135,11,5,1,4,6,4,18,22.2,14,16,4,12,0,11,11,0
2136,24,13,9,12,3,18,37,48.6,19,20,2,18,9,33,4,0
2137,57,31,33,19,5,19,36,52.8,17,37,7,30,41,98,50,0
2138,0,0,0,0,0,0,2,0.0,2,0,0,0,0,0,3,0
2139,24,15,8,13,3,10,20,50.0,10,8,0,8,13,37,5,0
2140,16,9,4,10,2,9,17,52.9,8,19,2,17,8,24,5,0
2141,0,0,0,0,0,0,0,0.0,0,0,0,0,0,0,6,0
2142,25,18,8,14,3,17,30,56.7,13,15,2,13,14,39,6,0
2143,24,18,16,5,3,16,24,66.7,8,17,10,7,19,43,48,0
2144,18,9,6,8,4,8,24,33.3,16,7,0,7,8,26,10,0
2145,10,6,5,1,4,7,15,46.7,8,8,1,7,8,18,7,0
2146,24,13,17,7,0,9,22,40.9,13,10,6,4,3,27,17,0
2147,23,17,13,9,1,10,21,47.6,11,11,3,8,11,34,13,0
2148,2,1,0,1,1,0,4,0.0,4,9,0,9,1,3,2,0
2149,1,1,0,1,0,1,1,100.0,0,0,0,0,0,1,0,0
2150,3,3,2,1,0,0,1,0.0,1,2,0,2,1,4,1,0
2151,2,1,1,0,1,1,5,20.0,4,1,0,1,0,2,2,0
2152,5,4,1,2,2,1,7,14.3,6,3,1,2,2,7,1,0
2153,7,3,2,2,3,2,5,40.0,3,2,0,2,2,9,2,0
2154,1,1,0,1,0,0,1,0.0,1,1,0,1,0,1,3,0
2155,4,2,1,2,1,3,6,50.0,3,3,0,3,0,4,2,0
2156,0,0,0,0,0,0,0,0.0,0,0,0,0,0,0,1,0
2157,2,2,2,0,0,2,3,66.7,1,0,0,0,0,2,2,0
2158,0,0,0,0,0,0,1,0.0,1,1,0,1,0,0,1,0
2159,0,0,0,0,0,0,0,0.0,0,0,0,0,0,0,0,0
2160,0,0,0,0,0,0,0,0.0,0,0,0,0,0,0,0,0
2161,46,21,24,17,5,21,49,42.9,28,26,12,14,34,80,72,0
2162,56,32,26,25,5,31,57,54.4,26,39,5,34,24,80,13,0
2163,56,35,39,13,4,38,46,82.6,8,39,15,24,52,108,136,1
2164,54,36,21,25,8,24,52,46.2,28,28,6,22,30,84,47,0
2165,17,12,6,5,6,6,21,28.6,15,10,0,10,10,27,11,2
2166,27,14,19,7,1,16,29,55.2,13,42,33,9,25,52,116,1
2167,12,6,3,7,2,3,17,17.6,14,11,2,9,7,19,18,0
2168,26,11,8,12,6,13,34,38.2,21,20,5,15,17,43,15,0
2169,78,52,44,28,6,39,62,62.9,23,47,10,37,18,96,70,1
2170,0,0,0,0,0,0,0,0.0,0,0,0,0,0,0,13,5
2171,18,10,7,6,5,11,24,45.8,13,21,1,20,7,25,6,0
2172,25,16,11,9,5,13,28,46.4,15,16,2,14,9,34,13,0
2173,29,20,19,8,2,16,35,45.7,19,24,11,13,22,51,61,3
2174,7,6,2,5,0,3,10,30.0,7,11,3,8,4,11,19,0
2175,0,0,0,0,0,0,0,0.0,0,0,0,0,1,1,4,0
2176,11,7,8,2,1,8,14,57.1,6,7,2,5,12,23,25,0
2177,3,2,0,1,2,1,2,50.0,1,2,0,2,1,4,3,1
2178,13,8,11,1,1,3,4,75.0,1,0,0,0,5,18,15,1
2179,13,7,4,7,2,4,15,26.7,11,9,2,7,5,18,5,1
2180,7,6,1,6,0,4,10,40.0,6,2,0,2,2,9,2,0
2181,0,0,0,0,0,0,3,0.0,3,4,0,4,0,0,1,0
2182,4,3,2,1,1,2,4,50.0,2,3,0,3,1,5,1,0
2183,1,0,1,0,0,1,3,33.3,2,1,0,1,1,2,1,0
2184,1,0,1,0,0,1,1,100.0,0,1,0,1,1,2,1,0
2185,1,1,0,1,0,1,2,50.0,1,1,0,1,0,1,0,0
2186,63,43,45,16,2,26,46,56.5,20,48,29,19,55,118,148,1
2187,1,1,1,0,0,1,4,25.0,3,0,0,0,3,4,17,4
2188,34,24,20,10,4,22,39,56.4,17,39,20,19,27,61,113,1
2189,34,20,28,5,1,27,40,67.5,13,25,13,12,25,59,151,0
2190,19,9,9,7,3,7,22,31.8,15,18,3,15,11,30,27,1
2191,37,18,16,11,10,24,47,51.1,23,26,2,24,11,48,20,1
2192,73,42,48,19,6,50,82,61.0,32,31,15,16,36,109,78,0
2193,64,44,32,26,6,34,57,59.6,23,35,3,32,24,88,33,0
2194,24,18,14,3,7,16,43,37.2,27,20,4,16,7,31,35,0
2195,34,24,16,15,3,17,47,36.2,30,22,3,19,22,56,38,0
2196,23,15,13,9,1,11,25,44.0,14,15,6,9,25,48,29,0
2197,45,27,25,18,2,22,43,51.2,21,19,5,14,18,63,59,0
2198,4,3,1,0,3,3,8,37.5,5,6,3,3,0,4,11,0
2199,31,20,14,15,2,12,27,44.4,15,18,2,16,13,44,12,2
2200,15,9,9,4,2,9,16,56.3,7,9,2,7,5,20,8,0
2201,11,9,4,5,2,7,11,63.6,4,7,2,5,6,17,16,0
2202,2,2,0,1,1,1,5,20.0,4,1,0,1,0,2,19,0
2203,17,7,7,9,1,7,16,43.8,9,3,2,1,6,23,5,0
2204,6,3,5,1,0,5,9,55.6,4,6,2,4,6,12,9,0
2205,6,3,3,2,1,4,6,66.7,2,1,0,1,6,12,8,0
2206,0,0,0,0,0,0,0,0.0,0,0,0,0,0,0,2,0
2207,1,0,1,0,0,0,3,0.0,3,0,0,0,1,2,3,0
2208,6,3,3,3,0,4,4,100.0,0,2,1,1,0,6,2,0
2209,2,2,0,1,1,1,7,14.3,6,2,0,2,4,6,4,0
2210,5,5,3,2,0,4,5,80.0,1,2,0,2,0,5,1,0
2211,0,0,0,0,0,0,0,0.0,0,1,0,1,0,0,0,0
2212,1,0,1,0,0,0,0,0.0,0,0,0,0,1,2,0,0
2213,0,0,0,0,0,0,1,0.0,1,2,1,1,0,0,1,0
2214,0,0,0,0,0,0,1,0.0,1,0,0,0,0,0,0,0
2215,39,18,13,15,11,19,39,48.7,20,31,0,31,11,50,44,0
2216,115,66,57,50,8,51,99,51.5,48,59,18,41,41,156,88,1
2217,29,17,14,15,0,14,24,58.3,10,33,23,10,56,85,118,1
2218,2,2,2,0,0,2,6,33.3,4,0,0,0,0,2,17,1
2219,74,42,29,31,14,35,69,50.7,34,40,7,33,30,104,60,1
2220,57,38,35,18,4,31,61,50.8,30,39,13,26,38,95,75,1
2221,50,32,20,21,9,23,51,45.1,28,23,5,18,35,85,31,0
2222,57,37,33,20,4,32,51,62.7,19,19,6,13,26,83,67,0
2223,24,15,10,8,6,6,22,27.3,16,19,3,16,1,25,8,0
2224,22,11,13,6,3,15,27,55.6,12,24,9,15,24,46,82,0
2225,28,23,10,9,9,11,22,50.0,11,14,0,14,9,37,8,0
2226,11,3,2,5,4,4,20,20.0,16,14,1,13,1,12,7,0
2227,39,29,23,13,3,11,24,45.8,13,35,11,24,16,55,33,0
2228,19,11,7,9,3,7,23,30.4,16,15,3,12,9,28,4,0
2229,17,11,10,6,1,12,16,75.0,4,14,12,2,14,31,65,1
2230,16,9,7,6,3,8,13,61.5,5,8,0,8,4,20,14,0
2231,4,3,1,2,1,1,3,33.3,2,3,0,3,0,4,3,0
2232,0,0,0,0,0,0,0,0.0,0,0,0,0,0,0,6,0
2233,5,3,2,1,2,3,16,18.8,13,5,1,4,3,8,2,0
2234,1,0,0,1,0,1,2,50.0,1,0,0,0,1,2,0,0
2235,0,0,0,0,0,0,1,0.0,1,5,0,5,0,0,3,0
2236,2,1,0,0,2,1,3,33.3,2,3,0,3,0,2,4,0
2237,4,3,3,0,1,4,5,80.0,1,4,2,2,3,7,3,0
2238,2,1,2,0,0,2,3,66.7,1,5,0,5,1,3,2,0
2239,4,2,4,0,0,1,2,50.0,1,4,2,2,4,8,6,0
2240,1,0,1,0,0,0,0,0.0,0,2,0,2,0,1,1,0
2241,0,0,0,0,0,0,0,0.0,0,0,0,0,1,1,1,0
2242,1,1,1,0,0,0,0,0.0,0,0,0,0,0,1,0,0
2243,0,0,0,0,0,0,0,0.0,0,0,0,0,0,0,0,0
2244,2,0,2,0,0,2,3,66.7,1,0,0,0,1,3,14,2
2245,83,57,56,21,6,42,92,45.7,50,70,26,44,48,131,64,1
2246,48,30,35,9,4,26,38,68.4,12,44,27,17,17,65,108,0
2247,13,6,6,2,5,7,26,26.9,19,5,0,5,1,14,16,0
2248,17,9,7,2,8,9,21,42.9,12,16,2,14,4,21,9,0
2249,43,29,30,13,0,23,49,46.9,26,33,9,24,17,60,49,1
2250,17,11,16,1,0,10,16,62.5,6,20,15,5,23,40,113,3
2251,37,21,15,17,5,16,46,34.8,30,10,3,7,11,48,8,0
2252,13,9,8,4,1,3,12,25.0,9,6,0,6,0,13,9,0
2253,40,26,28,9,3,30,52,57.7,22,23,10,13,12,52,32,1
2254,39,18,24,13,2,19,26,73.1,7,18,5,13,11,50,39,0
2255,12,7,2,5,5,1,6,16.7,5,13,5,8,3,15,16,0
2256,45,28,22,16,7,24,40,60.0,16,19,6,13,28,73,40,0
2257,15,10,6,6,3,7,21,33.3,14,9,4,5,5,20,14,1
2258,5,4,0,3,2,0,3,0.0,3,8,0,8,1,6,5,0
2259,29,22,18,10,1,14,20,70.0,6,24,9,15,17,46,62,0
2260,18,12,14,3,1,11,16,68.8,5,13,6,7,10,28,40,1
2261,10,5,7,2,1,4,14,28.6,10,5,1,4,4,14,8,0
2262,8,6,6,2,0,5,6,83.3,1,19,13,6,7,15,41,1
2263,24,16,11,10,3,13,25,52.0,12,14,3,11,6,30,9,0
2264,21,14,7,12,2,4,14,28.6,10,10,4,6,8,29,13,1
2265,39,14,17,20,2,16,33,48.5,17,30,7,23,10,49,38,0
2266,13,8,7,3,3,7,11,63.6,4,4,0,4,1,14,1,0
2267,3,2,2,1,0,3,4,75.0,1,7,6,1,6,9,11,0
2268,0,0,0,0,0,0,3,0.0,3,1,1,0,0,0,1,0
2269,2,1,0,2,0,0,0,0.0,0,0,0,0,0,2,0,0
2270,1,1,1,0,0,0,0,0.0,0,1,0,1,0,1,1,0
2271,95,53,48,36,11,41,67,61.2,26,41,13,28,30,125,70,1
2272,2,1,2,0,0,2,4,50.0,2,2,0,2,0,2,15,3
2273,52,25,33,16,3,23,33,69.7,10,44,30,14,25,77,143,1
2274,79,58,56,14,9,48,92,52.2,44,30,2,28,28,107,78,2
2275,57,31,27,28,2,25,42,59.5,17,39,16,23,29,86,51,1
2276,60,29,39,18,3,39,77,50.6,38,32,13,19,30,90,78,0
2277,36,24,23,9,4,22,33,66.7,11,57,36,21,32,68,169,1
2278,16,9,4,5,7,8,14,57.1,6,15,0,15,12,28,5,0
2279,30,13,9,13,8,11,37,29.7,26,14,2,12,13,43,18,0
2280,4,2,0,4,0,1,7,14.3,6,7,4,3,0,4,32,0
2281,18,9,0,8,10,9,23,39.1,14,16,3,13,3,21,15,0
2282,13,7,4,3,6,5,24,20.8,19,17,1,16,7,20,15,0
2283,41,23,30,9,2,31,48,64.6,17,17,7,10,20,61,72,2
2284,9,4,2,5,2,3,9,33.3,6,7,1,6,0,9,5,0
2285,27,22,18,8,1,7,14,50.0,7,14,3,11,10,37,16,0
2286,16,9,10,3,3,6,12,50.0,6,6,0,6,2,18,2,0
2287,28,14,22,5,1,12,25,48.0,13,13,2,11,18,46,33,0
2288,12,9,6,3,3,6,15,40.0,9,3,0,3,3,15,4,0
2289,19,8,7,6,6,5,11,45.5,6,9,1,8,8,27,5,0
2290,4,4,3,1,0,2,3,66.7,1,12,8,4,4,8,21,1
2291,0,0,0,0,0,0,0,0.0,0,0,0,0,0,0,3,0
2292,0,0,0,0,0,0,0,0.0,0,0,0,0,0,0,0,1
2293,1,1,0,1,0,0,1,0.0,1,1,0,1,1,2,0,0
2294,0,0,0,0,0,0,0,0.0,0,0,0,0,1,1,1,0
2295,0,0,0,0,0,0,0,0.0,0,0,0,0,0,0,0,0
2296,0,0,0,0,0,0,1,0.0,1,1,0,1,0,0,14,4
2297,97,58,67,25,5,64,99,64.6,35,52,14,38,45,142,137,2
2298,66,42,27,29,10,26,55,47.3,29,43,13,30,49,115,36,0
2299,76,48,58,14,4,31,47,66.0,16,39,12,27,43,119,60,3
2300,21,11,15,5,1,11,22,50.0,11,39,25,14,38,59,121,0
2301,45,27,28,13,4,20,43,46.5,23,25,16,9,30,75,113,0
2302,36,26,23,12,1,16,54,29.6,38,33,4,29,15,51,27,0
2303,15,10,8,5,2,4,17,23.5,13,18,0,18,11,26,18,0
2304,34,17,17,11,6,10,24,41.7,14,16,6,10,15,49,22,0
2305,6,5,2,3,1,4,7,57.1,3,12,3,9,1,7,16,0
2306,33,18,16,11,6,17,31,54.8,14,21,4,17,12,45,16,0
2307,14,9,7,7,0,8,11,72.7,3,14,8,6,9,23,52,1
2308,20,11,8,7,5,9,25,36.0,16,16,0,16,9,29,16,0
2309,20,14,10,9,1,9,18,50.0,9,16,3,13,10,30,10,0
2310,24,14,9,12,3,8,20,40.0,12,19,3,16,9,33,19,0
2311,12,7,2,6,4,4,8,50.0,4,3,1,2,1,13,13,0
2312,26,17,19,4,3,14,20,70.0,6,15,5,10,17,43,33,1
2313,3,3,3,0,0,2,4,50.0,2,5,0,5,5,8,20,1
2314,12,9,2,7,3,3,13,23.1,10,3,0,3,5,17,6,0
2315,7,5,5,2,0,2,8,25.0,6,3,1,2,8,15,29,0
2316,9,5,7,2,0,7,13,53.8,6,8,5,3,8,17,13,0
2317,7,4,3,3,1,1,3,33.3,2,5,0,5,0,7,9,0
2318,9,6,4,4,1,6,12,50.0,6,2,0,2,2,11,12,0
2319,5,5,4,1,0,4,5,80.0,1,4,1,3,7,12,7,0
2320,3,2,1,2,0,1,3,33.3,2,3,0,3,1,4,0,0
2321,2,0,0,1,1,2,4,50.0,2,2,0,2,1,3,0,0
2322,0,0,0,0,0,0,0,0.0,0,1,0,1,0,0,0,0
2323,48,29,34,13,1,25,56,44.6,31,57,32,25,41,89,146,2
2324,2,2,2,0,0,2,3,66.7,1,1,0,1,1,3,21,1
2325,30,19,21,9,0,18,39,46.2,21,39,31,8,24,54,93,1
2326,48,31,22,17,9,23,61,37.7,38,31,8,23,11,59,43,1
2327,16,9,11,3,2,8,22,36.4,14,10,0,10,5,21,8,0
2328,52,27,36,14,2,33,49,67.3,16,36,22,14,32,84,136,2
2329,44,29,30,9,5,29,65,44.6,36,27,12,15,36,80,66,1
2330,44,24,21,16,7,18,43,41.9,25,31,6,25,19,63,48,0
2331,91,59,59,30,2,50,83,60.2,33,35,11,24,28,119,68,0
2332,42,28,24,12,6,25,42,59.5,17,14,6,8,13,55,52,0
2333,15,8,9,3,3,9,14,64.3,5,5,0,5,7,22,12,0
2334,16,8,5,8,3,2,16,12.5,14,11,1,10,8,24,16,0
2335,11,8,4,5,2,5,18,27.8,13,13,1,12,11,22,13,0
2336,33,20,19,13,1,16,31,51.6,15,18,3,15,16,49,34,0
2337,5,2,1,3,1,2,7,28.6,5,3,0,3,4,9,7,0
2338,30,18,20,8,2,9,25,36.0,16,13,4,9,9,39,19,0
2339,7,4,1,5,1,1,2,50.0,1,11,0,11,1,8,9,0
2340,12,5,7,2,3,8,16,50.0,8,10,0,10,2,14,1,1
2341,13,4,7,5,1,8,11,72.7,3,14,5,9,14,27,37,1
2342,2,1,0,2,0,0,3,0.0,3,5,2,3,0,2,4,0
2343,14,10,7,5,2,9,14,64.3,5,2,0,2,6,20,5,0
2344,8,7,4,3,1,5,9,55.6,4,3,1,2,3,11,6,0
2345,5,2,3,2,0,2,6,33.3,4,2,0,2,4,9,7,0
2346,2,0,0,2,0,0,1,0.0,1,0,0,0,0,2,0,0
2347,1,1,1,0,0,1,3,33.3,2,2,0,2,0,1,0,0
2348,3,0,1,1,1,2,3,66.7,1,2,0,2,0,3,0,0
2349,0,0,0,0,0,0,0,0.0,0,0,0,0,0,0,2,1
2350,0,0,0,0,0,0,0,0.0,0,0,0,0,0,0,1,0
2351,1,1,1,0,0,1,1,100.0,0,1,0,1,1,2,1,0
2352,2,1,1,0,1,1,4,25.0,3,4,1,3,0,2,2,0
2353,9,5,2,4,3,4,6,66.7,2,7,2,5,3,12,1,0
2354,2,2,1,0,1,2,4,50.0,2,2,0,2,0,2,1,0
2355,1,0,1,0,0,1,1,100.0,0,1,0,1,0,1,1,0
2356,3,3,2,1,0,2,3,66.7,1,0,0,0,0,3,1,0
2357,1,0,1,0,0,1,3,33.3,2,0,0,0,0,1,1,0
2358,0,0,0,0,0,0,1,0.0,1,0,0,0,0,0,0,0
2359,0,0,0,0,0,0,0,0.0,0,0,0,0,0,0,0,0
2360,0,0,0,0,0,0,2,0.0,2,0,0,0,2,2,8,2
2361,48,27,28,18,2,21,28,75.0,7,50,36,14,36,84,106,2
2362,39,24,15,12,12,9,25,36.0,16,19,3,16,13,52,17,0
2363,35,17,15,13,7,17,34,50.0,17,38,14,24,31,66,44,1
2364,60,39,37,16,7,33,62,53.2,29,22,3,19,47,107,60,1
2365,40,25,28,12,0,16,30,53.3,14,45,21,24,27,67,116,0
2366,13,8,5,3,5,4,11,36.4,7,15,5,10,4,17,38,0
2367,34,22,27,5,2,14,40,35.0,26,32,12,20,30,64,78,1
2368,37,27,16,18,3,21,34,61.8,13,18,6,12,12,49,38,1
2369,16,11,7,6,3,6,25,24.0,19,24,3,21,15,31,7,1
2370,27,21,13,11,3,10,24,41.7,14,23,3,20,27,54,10,0
2371,27,12,17,8,2,8,16,50.0,8,9,0,9,2,29,5,0
2372,44,25,22,16,6,18,30,60.0,12,21,3,18,9,53,9,0
2373,18,14,7,7,4,11,31,35.5,20,12,1,11,6,24,6,1
2374,30,16,15,14,1,19,39,48.7,20,15,4,11,17,47,36,1
2375,6,3,2,3,1,2,17,11.8,15,9,0,9,2,8,5,0
2376,5,4,1,1,3,2,5,40.0,3,2,0,2,2,7,3,0
2377,3,1,2,0,1,1,2,50.0,1,4,1,3,0,3,7,0
2378,15,8,4,7,4,6,14,42.9,8,9,3,6,8,23,15,0
2379,5,1,1,2,2,2,10,20.0,8,1,0,1,0,5,2,0
2380,16,12,10,5,1,13,22,59.1,9,11,4,7,6,22,14,0
2381,1,1,0,1,0,0,1,0.0,1,0,0,0,0,1,2,0
2382,0,0,0,0,0,0,1,0.0,1,1,0,1,0,0,1,0
2383,0,0,0,0,0,0,0,0.0,0,0,0,0,0,0,0,0
2384,2,1,1,1,0,2,4,50.0,2,0,0,0,1,3,2,0
2385,1,0,0,1,0,0,0,0.0,0,2,2,0,0,1,0,0
2386,1,1,1,0,0,1,3,33.3,2,2,0,2,1,2,0,0
2387,3,1,1,1,1,2,8,25.0,6,2,0,2,4,7,4,0
2388,1,0,0,1,0,0,0,0.0,0,0,0,0,0,1,0,0
2389,0,0,0,0,0,0,0,0.0,0,0,0,0,0,0,0,0
2390,0,0,0,0,0,0,0,0.0,0,0,0,0,0,0,0,0
2391,47,34,22,13,12,24,42,57.1,18,39,2,37,43,90,40,0
2392,26,15,18,4,4,16,20,80.0,4,27,20,7,11,37,89,0
2393,16,15,2,9,5,5,19,26.3,14,14,0,14,8,24,6,0
2394,42,34,14,18,10,12,36,33.3,24,55,5,50,21,63,17,0
2395,47,32,28,15,4,23,42,54.8,19,28,9,19,22,69,54,4
2396,53,34,19,25,9,24,59,40.7,35,22,4,18,17,70,11,1
2397,38,23,19,17,2,9,18,50.0,9,21,13,8,28,66,52,1
2398,18,13,5,5,8,3,12,25.0,9,13,0,13,1,19,3,2
2399,0,0,0,0,0,0,1,0.0,1,0,0,0,0,0,15,1
2400,76,47,39,29,8,23,39,59.0,16,36,8,28,29,105,29,1
2401,15,10,12,2,1,11,14,78.6,3,12,2,10,13,28,26,1
2402,18,10,9,7,2,6,13,46.2,7,23,13,10,18,36,56,0
2403,22,15,10,6,6,9,25,36.0,16,13,4,9,21,43,9,0
2404,29,19,4,16,9,6,13,46.2,7,16,1,15,5,34,2,0
2405,6,3,1,4,1,0,7,0.0,7,11,1,10,6,12,11,0
2406,25,17,11,12,2,13,31,41.9,18,16,3,13,19,44,28,1
2407,37,25,22,14,1,18,25,72.0,7,27,5,22,12,49,36,0
2408,13,9,7,5,1,4,8,50.0,4,10,7,3,15,28,34,0
2409,0,0,0,0,0,0,1,0.0,1,0,0,0,0,0,4,0
2410,7,3,4,3,0,6,9,66.7,3,4,3,1,4,11,19,1
2411,10,5,4,5,1,5,14,35.7,9,9,2,7,0,10,4,1
2412,6,4,1,3,2,5,8,62.5,3,0,0,0,2,8,5,0
2413,1,0,1,0,0,0,0,0.0,0,0,0,0,0,1,0,0
2414,0,0,0,0,0,0,0,0.0,0,2,0,2,1,1,0,0
2415,0,0,0,0,0,0,1,0.0,1,1,1,0,0,0,1,0
2416,5,1,0,2,3,3,4,75.0,1,2,1,1,0,5,0,0
2417,0,0,0,0,0,0,0,0.0,0,0,0,0,0,0,1,0
2418,32,22,14,16,2,12,39,30.8,27,19,4,15,21,53,18,1
2419,37,23,22,10,5,28,51,54.9,23,32,12,20,25,62,83,5
2420,8,5,0,6,2,4,12,33.3,8,13,4,9,9,17,18,0
2421,64,44,35,21,8,38,58,65.5,20,35,6,29,29,93,59,1
2422,0,0,0,0,0,0,0,0.0,0,0,0,0,0,0,3,3
2423,23,14,7,14,2,16,28,57.1,12,23,10,13,21,44,41,0
2424,61,37,32,15,14,18,48,37.5,30,32,0,32,19,80,11,0
2425,27,22,11,15,1,12,17,70.6,5,20,11,9,12,39,66,2
2426,43,26,14,23,6,8,19,42.1,11,18,8,10,14,57,28,1
2427,22,14,18,3,1,13,18,72.2,5,20,16,4,12,34,65,0
2428,22,16,9,7,6,8,22,36.4,14,14,1,13,10,32,11,0
2429,14,8,6,6,2,4,18,22.2,14,17,1,16,13,27,11,0
2430,33,24,16,13,4,8,27,29.6,19,27,3,24,14,47,10,0
2431,20,11,11,6,3,7,11,63.6,4,14,1,13,5,25,21,1
2432,41,21,15,18,8,14,40,35.0,26,14,1,13,4,45,9,0
2433,10,7,9,1,0,6,8,75.0,2,13,10,3,11,21,50,0
2434,9,6,1,6,2,5,16,31.3,11,7,1,6,5,14,6,0
2435,34,20,17,14,3,13,24,54.2,11,12,2,10,10,44,18,0
2436,39,21,20,14,5,18,36,50.0,18,19,3,16,8,47,16,1
2437,0,0,0,0,0,0,1,0.0,1,0,0,0,0,0,5,1
2438,15,10,4,10,1,3,11,27.3,8,7,2,5,8,23,7,1
2439,6,5,5,1,0,4,10,40.0,6,0,0,0,2,8,4,0
2440,5,3,2,3,0,3,4,75.0,1,2,0,2,4,9,6,0
2441,3,2,2,0,1,0,2,0.0,2,3,0,3,0,3,5,0
2442,1,0,0,1,0,0,0,0.0,0,0,0,0,0,1,0,0
2443,1,1,0,0,1,0,1,0.0,1,1,0,1,0,1,0,0
2444,0,0,0,0,0,0,0,0.0,0,1,1,0,0,0,0,0
2445,0,0,0,0,0,0,1,0.0,1,0,0,0,0,0,0,0
2446,1,1,1,0,0,1,1,100.0,0,0,0,0,1,2,2,0
2447,2,2,2,0,0,2,4,50.0,2,0,0,0,0,2,12,1
2448,49,28,17,26,6,28,54,51.9,26,45,17,28,36,85,53,3
2449,29,18,11,14,4,13,35,37.1,22,27,11,16,22,51,66,2
2450,42,25,14,22,6,16,28,57.1,12,34,0,34,18,60,11,1
2451,47,21,33,13,1,29,47,61.7,18,37,19,18,21,68,113,0
2452,44,25,22,15,7,22,57,38.6,35,25,3,22,21,65,14,0
2453,4,3,2,1,1,0,2,0.0,2,8,1,7,0,4,17,0
2454,55,37,34,18,3,34,49,69.4,15,36,18,18,30,85,79,2
2455,64,37,28,30,6,30,56,53.6,26,30,8,22,24,88,45,1
2456,29,20,11,13,5,14,26,53.8,12,18,1,17,12,41,24,0
2457,33,20,21,12,0,17,22,77.3,5,28,19,9,20,53,63,4
2458,45,34,25,14,6,20,40,50.0,20,14,2,12,10,55,31,1
2459,25,16,17,6,2,15,32,46.9,17,15,5,10,10,35,41,3
2460,18,13,3,10,5,3,18,16.7,15,9,1,8,4,22,6,0
2461,11,8,8,3,0,9,10,90.0,1,17,11,6,7,18,50,1
2462,14,11,4,6,4,4,7,57.1,3,9,2,7,5,19,13,0
2463,5,2,0,5,0,4,10,40.0,6,10,2,8,4,9,6,1
2464,11,9,4,7,0,6,8,75.0,2,6,1,5,1,12,4,0
2465,10,8,4,5,1,4,12,33.3,8,8,3,5,8,18,7,1
2466,2,1,1,1,0,1,1,100.0,0,0,0,0,3,5,3,0
2467,1,0,0,0,1,0,0,0.0,0,0,0,0,0,1,1,0
2468,0,0,0,0,0,0,0,0.0,0,0,0,0,0,0,0,0
2469,1,1,0,1,0,0,0,0.0,0,1,0,1,1,2,0,0
2470,1,1,1,0,0,1,1,100.0,0,0,0,0,0,1,2,0
2471,2,0,2,0,0,2,2,100.0,0,1,0,1,0,2,0,0
2472,0,0,0,0,0,0,0,0.0,0,0,0,0,0,0,10,0
2473,66,44,27,32,7,36,79,45.6,43,37,12,25,16,82,34,1
2474,33,19,14,14,5,15,41,36.6,26,34,3,31,10,43,23,1
2475,35,21,23,12,0,17,24,70.8,7,40,21,19,16,51,119,0
2476,40,23,18,17,5,16,44,36.4,28,36,11,25,14,54,35,0
2477,46,25,29,13,4,28,51,54.9,23,27,9,18,30,76,93,0
2478,61,34,32,17,12,35,70,50.0,35,37,1,36,14,75,27,0
2479,31,21,11,14,6,15,38,39.5,23,28,1,27,11,42,15,2
2480,16,10,4,7,5,3,5,60.0,2,18,3,15,1,17,26,0
2481,38,22,16,18,4,26,54,48.1,28,19,3,16,9,47,36,1
2482,27,19,16,7,4,15,30,50.0,15,29,15,14,27,54,61,1
2483,45,25,15,29,1,19,40,47.5,21,20,3,17,28,73,24,2
2484,30,19,18,4,8,18,46,39.1,28,19,0,19,9,39,20,0
2485,22,15,3,11,8,5,17,29.4,12,13,0,13,2,24,6,0
2486,25,14,15,9,1,12,19,63.2,7,25,6,19,16,41,46,0
2487,64,39,29,29,6,30,49,61.2,19,36,9,27,14,78,56,0
2488,18,10,10,7,1,5,16,31.3,11,16,12,4,10,28,95,0
2489,5,2,0,3,2,3,6,50.0,3,2,0,2,1,6,0,0
2490,30,22,16,11,3,19,22,86.4,3,10,2,8,15,45,21,0
2491,7,5,4,3,0,3,4,75.0,1,5,3,2,4,11,27,0
2492,4,4,3,1,0,2,7,28.6,5,2,0,2,1,5,6,0
2493,3,1,2,1,0,1,2,50.0,1,0,0,0,0,3,0,0
2494,1,0,0,1,0,0,1,0.0,1,5,0,5,6,7,2,0
2495,1,1,1,0,0,0,0,0.0,0,1,0,1,1,2,7,0
2496,5,4,2,2,1,4,5,80.0,1,1,0,1,1,6,3,0
2497,1,0,0,1,0,0,0,0.0,0,0,0,0,0,1,1,0
2498,0,0,0,0,0,0,1,0.0,1,0,0,0,0,0,0,0
2499,2,1,1,1,0,2,3,66.7,1,0,0,0,1,3,9,0
2500,24,17,6,8,10,13,34,38.2,21,42,8,34,14,38,29,0
2501,42,28,29,11,2,28,45,62.2,17,49,25,24,31,73,104,0
2502,20,11,11,9,0,7,14,50.0,7,23,11,12,33,53,104,0
2503,34,23,6,25,3,9,30,30.0,21,36,2,34,17,51,23,0
2504,31,12,9,15,7,13,36,36.1,23,18,2,16,3,34,4,1
2505,56,39,26,24,6,42,71,59.2,29,28,6,22,15,71,44,0
2506,49,31,15,26,8,24,49,49.0,25,18,5,13,12,61,17,0
2507,19,11,3,10,6,8,21,38.1,13,5,1,4,10,29,5,0
2508,40,22,25,10,5,27,53,50.9,26,24,6,18,15,55,50,0
2509,33,25,13,14,6,19,33,57.6,14,28,9,19,20,53,62,0
2510,40,20,11,23,6,19,49,38.8,30,19,7,12,32,72,35,1
2511,45,28,11,23,11,23,42,54.8,19,32,5,27,23,68,27,0
2512,23,14,9,9,5,7,24,29.2,17,23,0,23,5,28,13,0
2513,18,9,15,3,0,12,19,63.2,7,8,5,3,11,29,34,1
2514,44,32,11,26,7,20,36,55.6,16,16,6,10,15,59,18,1
2515,12,10,2,6,4,5,10,50.0,5,13,2,11,2,14,9,0
2516,17,11,4,7,6,12,24,50.0,12,9,3,6,8,25,11,0
2517,5,1,2,3,0,1,3,33.3,2,4,1,3,0,5,0,0
2518,7,5,1,5,1,5,18,27.8,13,6,0,6,7,14,15,0
2519,2,1,0,0,2,2,2,100.0,0,2,1,1,0,2,6,0
2520,8,4,4,2,2,2,3,66.7,1,1,0,1,1,9,0,0
2521,0,0,0,0,0,0,0,0.0,0,0,0,0,0,0,0,0
2522,9,6,2,4,3,4,9,44.4,5,10,1,9,3,12,9,0
2523,0,0,0,0,0,0,6,0.0,6,5,0,5,0,0,2,0
2524,1,1,1,0,0,1,1,100.0,0,0,0,0,0,1,1,0
2525,0,0,0,0,0,0,0,0.0,0,0,0,0,0,0,0,0
2526,0,0,0,0,0,0,0,0.0,0,0,0,0,0,0,24,2
2527,49,27,18,29,2,23,42,54.8,19,33,9,24,37,86,54,0
2528,32,25,20,10,2,19,26,73.1,7,28,19,9,32,64,97,3
2529,31,22,16,15,0,17,30,56.7,13,26,15,11,28,59,96,1
2530,77,43,25,34,18,22,48,45.8,26,36,11,25,16,93,55,3
2531,42,28,13,20,9,15,43,34.9,28,23,4,19,12,54,21,0
2532,44,19,24,17,3,25,43,58.1,18,27,8,19,24,68,59,2
2533,26,17,15,6,5,9,23,39.1,14,21,2,19,11,37,8,1
2534,23,18,7,11,5,7,21,33.3,14,25,4,21,4,27,12,0
2535,32,21,7,16,9,10,26,38.5,16,18,1,17,6,38,5,0
2536,31,17,6,20,5,13,30,43.3,17,19,8,11,6,37,17,0
2537,25,15,21,4,0,14,22,63.6,8,17,6,11,10,35,53,1
2538,22,15,8,11,3,9,22,40.9,13,16,0,16,4,26,10,0
2539,37,24,16,18,3,18,27,66.7,9,22,8,14,10,47,45,0
2540,38,22,15,19,4,15,30,50.0,15,24,1,23,14,52,17,1
2541,15,10,2,8,5,4,8,50.0,4,9,0,9,0,15,10,0
2542,36,21,20,10,6,24,35,68.6,11,16,8,8,9,45,33,0
2543,2,2,0,0,2,0,4,0.0,4,3,0,3,1,3,3,0
2544,2,2,0,2,0,0,1,0.0,1,3,0,3,1,3,0,0
2545,11,7,5,4,2,6,14,42.9,8,12,10,2,7,18,26,0
2546,9,7,7,1,1,5,5,100.0,0,2,1,1,8,17,7,0
2547,24,15,12,10,2,15,25,60.0,10,8,3,5,7,31,17,0
2548,11,7,3,6,2,0,2,0.0,2,4,0,4,0,11,5,0
2549,16,13,4,7,5,5,8,62.5,3,2,0,2,3,19,5,1
2550,4,1,0,3,1,2,2,100.0,0,1,0,1,1,5,6,0
2551,4,3,3,1,0,2,7,28.6,5,6,0,6,1,5,1,0
2552,0,0,0,0,0,0,0,0.0,0,0,0,0,0,0,0,0
2553,5,3,2,3,0,4,8,50.0,4,3,0,3,0,5,2,0
2554,0,0,0,0,0,0,0,0.0,0,0,0,0,1,1,2,0
2555,2,1,2,0,0,0,0,0.0,0,1,0,1,0,2,0,0
2556,0,0,0,0,0,0,0,0.0,0,0,0,0,0,0,3,0
2557,34,24,24,10,0,23,38,60.5,15,31,18,13,31,65,150,0
2558,59,32,16,33,10,21,49,42.9,28,42,4,38,22,81,18,0
2559,0,0,0,0,0,0,3,0.0,3,0,0,0,1,1,13,1
2560,41,27,15,21,5,14,38,36.8,24,19,1,18,10,51,7,0
2561,7,3,1,2,4,2,5,40.0,3,8,2,6,2,9,15,0
2562,35,24,17,18,0,17,27,63.0,10,23,14,9,23,58,108,0
2563,52,36,17,29,6,30,53,56.6,23,29,6,23,17,69,23,1
2564,53,30,21,24,8,34,55,61.8,21,27,6,21,29,82,44,0
2565,38,24,21,13,4,17,31,54.8,14,31,6,25,19,57,62,0
2566,34,22,14,16,4,20,53,37.7,33,13,5,8,22,56,40,1
2567,25,19,15,9,1,17,34,50.0,17,23,5,18,15,40,62,0
2568,48,29,19,24,5,22,33,66.7,11,20,5,15,32,80,31,0
2569,24,16,8,11,5,12,22,54.5,10,14,0,14,22,46,10,2
2570,20,12,5,9,6,6,17,35.3,11,22,4,18,7,27,7,0
2571,21,14,16,5,0,13,17,76.5,4,15,9,6,6,27,60,0
2572,16,11,12,3,1,8,12,66.7,4,6,3,3,11,27,27,0
2573,46,27,28,13,5,32,59,54.2,27,12,1,11,14,60,33,1
2574,15,10,5,7,3,5,10,50.0,5,9,0,9,7,22,3,0
2575,17,10,6,7,4,8,21,38.1,13,11,0,11,8,25,2,0
2576,0,0,0,0,0,0,1,0.0,1,0,0,0,0,0,2,0
2577,17,14,7,5,5,4,14,28.6,10,10,0,10,5,22,5,0
2578,15,11,4,10,1,9,14,64.3,5,11,0,11,5,20,8,0
2579,15,8,8,6,1,11,23,47.8,12,12,1,11,9,24,10,0
2580,20,12,11,7,2,10,16,62.5,6,8,1,7,8,28,9,1
2581,17,12,5,9,3,7,14,50.0,7,4,2,2,6,23,5,0
2582,0,0,0,0,0,0,3,0.0,3,0,0,0,2,2,2,0
2583,7,3,5,2,0,4,5,80.0,1,10,4,6,4,11,16,0
2584,2,1,0,2,0,1,3,33.3,2,2,0,2,1,3,4,0
2585,1,0,1,0,0,1,1,100.0,0,0,0,0,0,1,2,1
2586,4,3,3,1,0,4,5,80.0,1,3,1,2,3,7,10,0
2587,1,0,0,1,0,0,0,0.0,0,2,0,2,0,1,0,0
2588,2,2,1,1,0,2,2,100.0,0,2,2,0,2,4,9,1
2589,0,0,0,0,0,0,1,0.0,1,0,0,0,0,0,0,0
2590,1,1,0,0,1,1,1,100.0,0,0,0,0,1,2,3,0
2591,5,3,0,2,3,3,3,100.0,0,3,1,2,1,6,1,0
2592,3,1,3,0,0,3,4,75.0,1,0,0,0,2,5,10,3
2593,34,21,10,16,8,20,47,42.6,27,23,2,21,13,47,17,1
2594,6,3,1,2,3,2,6,33.3,4,9,4,5,0,6,26,0
2595,43,30,16,21,6,20,46,43.5,26,25,9,16,21,64,29,3
2596,25,12,10,7,8,11,25,44.0,14,24,7,17,9,34,24,0
2597,25,14,15,9,1,18,27,66.7,9,31,24,7,16,41,102,0
2598,42,29,26,10,6,19,30,63.3,11,26,15,11,21,63,114,0
2599,44,26,15,21,8,19,38,50.0,19,33,9,24,22,66,27,1
2600,36,21,11,16,9,10,20,50.0,10,10,2,8,13,49,13,0
2601,31,21,19,10,2,10,30,33.3,20,12,2,10,24,55,33,0
2602,35,25,19,13,3,19,34,55.9,15,21,6,15,31,66,45,0
2603,32,18,17,12,3,15,22,68.2,7,20,4,16,22,54,24,1
2604,27,13,18,7,2,12,15,80.0,3,12,2,10,17,44,65,0
2605,25,9,18,5,2,9,17,52.9,8,16,7,9,13,38,19,0
2606,13,8,8,5,0,7,14,50.0,7,10,7,3,8,21,41,0
2607,26,15,18,8,0,12,27,44.4,15,17,4,13,12,38,44,0
2608,20,12,8,10,2,5,13,38.5,8,14,4,10,16,36,15,0
2609,16,7,9,6,1,9,24,37.5,15,18,5,13,5,21,18,0
2610,6,4,1,2,3,2,7,28.6,5,8,0,8,2,8,3,0
2611,5,3,4,1,0,2,2,100.0,0,8,8,0,9,14,38,2
2612,5,3,1,4,0,3,13,23.1,10,9,1,8,7,12,4,0
2613,25,18,12,10,3,9,18,50.0,9,11,1,10,5,30,5,0
2614,17,13,8,8,1,7,15,46.7,8,11,1,10,3,20,9,0
2615,5,4,2,1,2,1,4,25.0,3,6,0,6,1,6,2,0
2616,10,6,4,6,0,5,8,62.5,3,5,2,3,8,18,36,1
2617,7,5,6,1,0,4,10,40.0,6,1,1,0,3,10,9,0
2618,2,2,1,0,1,0,2,0.0,2,0,0,0,0,2,0,0
2619,11,5,8,1,2,7,12,58.3,5,3,0,3,1,12,11,0
2620,0,0,0,0,0,0,0,0.0,0,0,0,0,0,0,1,0
2621,0,0,0,0,0,0,2,0.0,2,2,2,0,0,0,4,0
2622,0,0,0,0,0,0,0,0.0,0,1,1,0,0,0,1,0
2623,0,0,0,0,0,0,0,0.0,0,0,0,0,0,0,0,0
2624,78,53,36,36,6,37,71,52.1,34,41,10,31,49,127,71,0
2625,4,3,4,0,0,4,4,100.0,0,1,0,1,2,6,22,2
2626,16,8,5,8,3,9,29,31.0,20,24,5,19,5,21,27,0
2627,57,34,36,18,3,25,39,64.1,14,42,23,19,36,93,137,2
2628,37,25,14,16,7,13,56,23.2,43,23,1,22,20,57,12,0
2629,54,24,25,22,7,22,58,37.9,36,27,7,20,18,72,44,0
2630,30,17,10,14,6,15,44,34.1,29,19,0,19,14,44,5,0
2631,63,35,39,20,4,28,49,57.1,21,39,16,23,33,96,61,0
2632,71,36,44,23,4,43,67,64.2,24,18,3,15,11,82,42,0
2633,39,22,22,13,4,18,26,69.2,8,10,1,9,16,55,49,1
2634,26,15,22,4,0,15,23,65.2,8,18,7,11,18,44,84,1
2635,10,7,8,2,0,6,11,54.5,5,15,7,8,24,34,78,0
2636,23,13,7,11,5,10,24,41.7,14,14,2,12,11,34,9,0
2637,24,15,7,14,3,11,17,64.7,6,8,3,5,12,36,25,2
2638,18,11,9,9,0,11,13,84.6,2,17,7,10,11,29,62,0
2639,25,15,9,12,4,9,19,47.4,10,13,1,12,6,31,5,0
2640,5,2,1,2,2,3,6,50.0,3,4,0,4,1,6,9,0
2641,22,12,14,5,3,13,19,68.4,6,15,8,7,15,37,50,1
2642,17,12,7,7,3,3,9,33.3,6,13,0,13,11,28,6,0
2643,24,12,13,8,3,10,16,62.5,6,17,4,13,3,27,24,0
2644,5,3,3,1,1,1,10,10.0,9,11,0,11,7,12,10,0
2645,4,2,0,1,3,1,1,100.0,0,3,0,3,0,4,5,0
2646,1,0,0,0,1,1,6,16.7,5,0,0,0,1,2,2,0
2647,0,0,0,0,0,0,0,0.0,0,0,0,0,0,0,0,0
2648,2,1,0,2,0,0,0,0.0,0,0,0,0,0,2,0,0
2649,0,0,0,0,0,0,0,0.0,0,0,0,0,0,0,0,0
2650,0,0,0,0,0,0,0,0.0,0,0,0,0,0,0,0,0
2651,2,2,0,2,0,1,1,100.0,0,0,0,0,0,2,1,0
2652,0,0,0,0,0,0,0,0.0,0,0,0,0,0,0,2,0
2653,0,0,0,0,0,0,1,0.0,1,0,0,0,0,0,17,1
2654,42,24,10,27,5,12,45,26.7,33,23,3,20,22,64,22,0
2655,59,32,28,25,6,31,64,48.4,33,34,12,22,13,72,46,1
2656,62,42,40,17,5,38,75,50.7,37,24,8,16,28,90,69,0
2657,27,19,10,12,5,14,43,32.6,29,28,1,27,16,43,28,0
2658,61,36,29,27,5,31,86,36.0,55,25,2,23,35,96,30,0
2659,32,20,23,9,0,14,27,51.9,13,34,21,13,33,65,129,2
2660,35,19,28,5,2,21,35,60.0,14,31,26,5,23,58,115,0
2661,23,12,11,9,3,15,26,57.7,11,25,9,16,10,33,77,1
2662,6,3,1,4,1,0,4,0.0,4,11,2,9,1,7,14,0
2663,39,20,21,16,2,21,31,67.7,10,21,6,15,23,62,69,0
2664,8,4,2,3,3,4,9,44.4,5,16,5,11,1,9,12,0
2665,27,15,11,9,7,14,26,53.8,12,18,2,16,11,38,16,0
2666,16,6,7,7,2,10,25,40.0,15,4,0,4,4,20,9,0
2667,29,19,22,4,3,16,28,57.1,12,14,8,6,12,41,59,0
2668,14,10,10,4,0,10,16,62.5,6,8,4,4,13,27,43,0
2669,56,35,19,26,11,19,34,55.9,15,13,5,8,19,75,31,0
2670,17,12,2,14,1,5,12,41.7,7,8,0,8,5,22,4,0
2671,9,5,4,2,3,5,15,33.3,10,10,1,9,3,12,7,0
2672,7,5,2,3,2,5,17,29.4,12,10,0,10,5,12,3,0
2673,0,0,0,0,0,0,0,0.0,0,0,0,0,0,0,3,0
2674,5,5,3,2,0,3,7,42.9,4,2,1,1,1,6,2,0
2675,3,3,1,1,1,1,2,50.0,1,1,0,1,1,4,4,0
2676,0,0,0,0,0,0,0,0.0,0,2,0,2,0,0,0,0
2677,0,0,0,0,0,0,0,0.0,0,1,1,0,0,0,1,0
2678,0,0,0,0,0,0,0,0.0,0,0,0,0,0,0,0,0
2679,0,0,0,0,0,0,0,0.0,0,0,0,0,0,0,0,0
2680,0,0,0,0,0,0,0,0.0,0,0,0,0,0,0,0,0
2681,0,0,0,0,0,0,0,0.0,0,0,0,0,0,0,0,0
2682,1,1,0,1,0,1,1,100.0,0,0,0,0,0,1,0,0
2683,2,2,2,0,0,2,3,66.7,1,0,0,0,0,2,22,3
2684,45,24,25,13,7,31,38,81.6,7,36,15,21,18,63,58,0
2685,21,15,2,11,8,5,14,35.7,9,19,5,14,5,26,18,0
2686,33,18,26,6,1,19,35,54.3,16,24,15,9,15,48,119,3
2687,29,18,19,9,1,16,26,61.5,10,40,19,21,18,47,115,2
2688,43,26,18,20,5,13,37,35.1,24,27,2,25,16,59,11,0
2689,47,25,22,18,7,20,49,40.8,29,37,8,29,30,77,39,3
2690,30,19,7,19,4,9,24,37.5,15,15,1,14,11,41,22,0
2691,30,22,11,15,4,16,25,64.0,9,15,2,13,21,51,40,2
2692,27,18,14,10,3,17,42,40.5,25,31,5,26,15,42,21,0
2693,25,15,11,8,6,11,28,39.3,17,10,2,8,33,58,37,0
2694,32,18,13,17,2,15,31,48.4,16,16,5,11,11,43,50,0
2695,32,18,8,17,7,13,33,39.4,20,23,3,20,12,44,23,0
2696,27,15,16,10,1,17,25,68.0,8,14,7,7,12,39,39,1
2697,29,19,23,6,0,12,19,63.2,7,20,11,9,15,44,69,1
2698,10,4,4,2,4,2,10,20.0,8,9,1,8,5,15,11,0
2699,18,9,5,7,6,5,21,23.8,16,26,3,23,9,27,17,0
2700,3,2,1,1,1,3,11,27.3,8,14,0,14,4,7,8,0
2701,14,8,6,4,4,6,21,28.6,15,11,2,9,3,17,2,0
2702,12,9,9,2,1,5,10,50.0,5,7,1,6,8,20,18,0
2703,0,0,0,0,0,0,1,0.0,1,0,0,0,0,0,5,1
2704,6,2,2,2,2,3,8,37.5,5,2,1,1,2,8,2,0
2705,5,4,2,2,1,2,5,40.0,3,2,0,2,0,5,6,0
2706,1,0,1,0,0,1,1,100.0,0,1,0,1,0,1,0,0
2707,1,0,0,1,0,0,0,0.0,0,0,0,0,0,1,1,0
2708,0,0,0,0,0,0,0,0.0,0,1,0,1,0,0,3,0
2709,0,0,0,0,0,0,0,0.0,0,0,0,0,0,0,0,0
2710,2,1,0,1,1,0,0,0.0,0,0,0,0,0,2,0,0
2711,1,0,0,0,1,0,0,0.0,0,0,0,0,0,1,0,0
2712,0,0,0,0,0,0,2,0.0,2,0,0,0,0,0,21,6
2713,65,43,26,31,8,23,41,56.1,18,56,23,33,46,111,61,0
2714,11,6,3,5,3,4,21,19.0,17,9,0,9,4,15,4,0
2715,34,19,18,13,3,15,26,57.7,11,31,15,16,23,57,70,0
2716,68,37,43,20,5,37,57,64.9,20,40,11,29,35,103,80,0
2717,64,48,32,23,9,41,76,53.9,35,25,8,17,41,105,76,0
2718,9,5,2,2,5,5,22,22.7,17,7,0,7,4,13,16,0
2719,57,33,19,28,10,28,47,59.6,19,20,1,19,32,89,10,0
2720,28,21,15,13,0,19,35,54.3,16,30,18,12,13,41,111,0
2721,24,15,12,8,4,11,26,42.3,15,18,1,17,17,41,31,0
2722,41,22,25,11,5,21,33,63.6,12,18,7,11,16,57,53,0
2723,9,7,0,6,3,1,11,9.1,10,9,0,9,4,13,21,0
2724,30,21,13,14,3,9,28,32.1,19,15,2,13,21,51,25,0
2725,36,21,16,16,4,26,45,57.8,19,13,3,10,10,46,31,0
2726,7,4,6,0,1,5,7,71.4,2,7,5,2,8,15,27,0
2727,24,8,7,14,3,10,24,41.7,14,14,3,11,4,28,13,0
2728,24,13,2,15,7,9,15,60.0,6,12,1,11,5,29,5,0
2729,9,3,7,2,0,4,8,50.0,4,3,2,1,6,15,26,0
2730,17,8,8,5,4,4,7,57.1,3,3,0,3,0,17,8,0
2731,20,11,3,11,6,4,9,44.4,5,3,1,2,4,24,10,0
2732,16,11,3,11,2,7,15,46.7,8,7,2,5,8,24,7,0
2733,6,2,3,2,1,1,6,16.7,5,1,0,1,2,8,7,0
2734,0,0,0,0,0,0,1,0.0,1,0,0,0,0,0,4,0
2735,1,1,1,0,0,1,3,33.3,2,0,0,0,4,5,8,0
2736,0,0,0,0,0,0,0,0.0,0,1,0,1,0,0,2,0
2737,2,2,1,1,0,0,4,0.0,4,0,0,0,0,2,1,0
2738,5,3,4,0,1,5,6,83.3,1,0,0,0,0,5,0,0
2739,0,0,0,0,0,0,1,0.0,1,0,0,0,0,0,1,0
2740,1,0,0,0,1,1,1,100.0,0,0,0,0,0,1,0,0
2741,0,0,0,0,0,0,0,0.0,0,0,0,0,0,0,1,0
2742,0,0,0,0,0,0,0,0.0,0,0,0,0,0,0,0,0
2743,0,0,0,0,0,0,0,0.0,0,0,0,0,0,0,0,0
2744,0,0,0,0,0,0,0,0.0,0,0,0,0,0,0,0,0
2745,21,11,1,15,5,8,38,21.1,30,15,1,14,5,26,17,0
2746,62,38,44,11,7,37,80,46.3,43,38,7,31,17,79,49,2
2747,51,28,30,19,2,23,49,46.9,26,38,24,14,52,103,153,3
2748,11,6,4,6,1,1,15,6.7,14,23,3,20,10,21,8,0
2749,56,32,22,23,11,24,63,38.1,39,28,2,26,18,74,34,0
2750,1,1,1,0,0,1,2,50.0,1,0,0,0,0,1,9,1
2751,36,30,30,5,1,19,28,67.9,9,35,28,7,34,70,159,2
2752,14,9,4,8,2,2,17,11.8,15,20,0,20,18,32,12,0
2753,39,21,12,22,5,22,43,51.2,21,23,4,19,12,51,17,0
2754,54,28,21,25,8,31,55,56.4,24,23,3,20,19,73,65,0
2755,33,21,17,9,7,23,37,62.2,14,24,12,12,22,55,78,0
2756,41,29,19,19,3,14,25,56.0,11,31,7,24,21,62,50,1
2757,0,0,0,0,0,0,1,0.0,1,0,0,0,0,0,6,0
2758,15,11,6,5,4,8,15,53.3,7,14,3,11,3,18,17,0
2759,15,13,7,7,1,12,21,57.1,9,11,3,8,5,20,25,0
2760,27,18,22,5,0,13,24,54.2,11,13,5,8,12,39,32,0
2761,15,9,9,6,0,9,12,75.0,3,9,2,7,10,25,23,0
2762,14,9,8,3,3,9,20,45.0,11,4,1,3,5,19,9,0
2763,19,17,3,13,3,8,20,40.0,12,7,1,6,2,21,5,0
2764,15,7,2,6,7,3,8,37.5,5,6,3,3,2,17,9,0
2765,13,5,6,5,2,7,18,38.9,11,14,1,13,5,18,8,0
2766,14,7,3,8,3,4,13,30.8,9,12,2,10,4,18,4,0
2767,24,18,13,9,2,13,24,54.2,11,16,0,16,9,33,4,0
2768,9,4,3,6,0,5,8,62.5,3,11,1,10,0,9,4,0
2769,8,3,6,2,0,4,8,50.0,4,3,1,2,4,12,28,0
2770,6,3,1,3,2,1,3,33.3,2,4,2,2,1,7,2,0
2771,6,1,3,2,1,4,6,66.7,2,3,0,3,3,9,3,0
2772,6,3,3,1,2,3,9,33.3,6,8,0,8,4,10,0,0
2773,2,0,2,0,0,0,0,0.0,0,1,0,1,0,2,2,0
2774,0,0,0,0,0,0,0,0.0,0,0,0,0,0,0,0,0
2775,0,0,0,0,0,0,0,0.0,0,0,0,0,0,0,0,0
2776,66,47,22,27,17,29,58,50.0,29,34,1,33,21,87,29,0
2777,10,7,3,4,3,0,10,0.0,10,9,1,8,7,17,29,1
2778,45,30,32,11,2,27,40,67.5,13,35,30,5,41,86,156,0
2779,65,41,53,12,0,30,49,61.2,19,23,15,8,38,103,116,2
2780,39,28,24,14,1,14,26,53.8,12,25,7,18,26,65,20,1
2781,37,27,21,14,2,22,40,55.0,18,15,7,8,22,59,48,0
2782,0,0,0,0,0,0,1,0.0,1,0,0,0,0,0,9,1
2783,31,24,18,10,3,17,31,54.8,14,17,9,8,27,58,56,0
2784,41,23,26,12,3,22,36,61.1,14,25,14,11,26,67,91,1
2785,37,22,17,15,5,22,57,38.6,35,40,4,36,6,43,6,0
2786,28,21,15,8,5,9,25,36.0,16,20,3,17,17,45,8,1
2787,33,21,20,12,1,9,14,64.3,5,12,2,10,4,37,25,0
2788,30,16,9,12,9,11,19,57.9,8,16,5,11,14,44,12,0
2789,46,26,28,14,4,23,34,67.6,11,26,6,20,15,61,54,0
2790,24,17,14,8,2,8,28,28.6,20,9,0,9,5,29,4,0
2791,6,3,2,2,2,5,9,55.6,4,12,0,12,0,6,11,0
2792,1,1,1,0,0,1,2,50.0,1,0,0,0,1,2,5,0
2793,5,2,2,2,1,1,6,16.7,5,9,2,7,2,7,5,0
2794,56,35,34,18,4,34,58,58.6,24,24,7,17,12,68,36,0
2795,23,18,7,14,2,9,12,75.0,3,6,1,5,7,30,8,0
2796,21,14,4,10,7,10,15,66.7,5,12,0,12,1,22,5,0
2797,9,8,2,4,3,5,9,55.6,4,2,0,2,7,16,9,0
2798,8,7,3,3,2,7,15,46.7,8,4,2,2,4,12,2,0
2799,2,2,1,1,0,1,2,50.0,1,2,0,2,1,3,1,0
2800,9,6,5,4,0,6,10,60.0,4,8,6,2,4,13,11,1
2801,12,8,9,2,1,8,11,72.7,3,2,0,2,3,15,9,1
2802,1,1,0,1,0,0,1,0.0,1,1,0,1,0,1,2,0
2803,4,2,4,0,0,3,3,100.0,0,3,0,3,0,4,1,0
2804,3,3,1,2,0,0,1,0.0,1,1,0,1,0,3,0,0
2805,0,0,0,0,0,0,0,0.0,0,0,0,0,0,0,0,0
2806,3,3,2,0,1,0,1,0.0,1,2,0,2,1,4,0,0
2807,0,0,0,0,0,0,0,0.0,0,1,1,0,0,0,2,0
2808,1,0,0,1,0,1,2,50.0,1,0,0,0,0,1,1,0
2809,0,0,0,0,0,0,0,0.0,0,0,0,0,1,1,0,0
2810,1,0,1,0,0,1,1,100.0,0,0,0,0,0,1,1,0
2811,2,1,2,0,0,2,2,100.0,0,0,0,0,0,2,14,0
2812,47,24,21,20,6,21,45,46.7,24,34,5,29,15,62,21,0
2813,34,18,19,13,2,18,30,60.0,12,26,11,15,29,63,112,1
2814,73,45,37,32,4,40,81,49.4,41,24,3,21,31,104,60,2
2815,91,50,40,46,5,46,93,49.5,47,28,14,14,39,130,59,3
2816,11,6,4,3,4,2,14,14.3,12,11,4,7,6,17,26,0
2817,35,17,26,9,0,24,32,75.0,8,33,20,13,29,64,114,0
2818,30,23,18,12,0,17,23,73.9,6,44,30,14,37,67,104,2
2819,39,26,13,21,5,12,31,38.7,19,20,4,16,16,55,16,0
2820,25,11,13,10,2,11,32,34.4,21,24,5,19,13,38,13,0
2821,17,8,6,4,7,2,7,28.6,5,16,5,11,3,20,17,0
2822,38,22,23,10,5,18,29,62.1,11,14,4,10,16,54,35,0
2823,33,16,16,17,0,18,35,51.4,17,24,8,16,31,64,30,1
2824,35,22,18,13,4,23,40,57.5,17,12,2,10,10,45,23,0
2825,45,27,27,17,1,30,43,69.8,13,12,6,6,32,77,47,1
2826,50,29,23,26,1,23,53,43.4,30,13,1,12,20,70,21,0
2827,38,23,19,13,6,16,27,59.3,11,17,3,14,17,55,27,0
2828,6,4,2,2,2,3,5,60.0,2,6,3,3,2,8,12,0
2829,12,5,4,5,3,6,13,46.2,7,5,2,3,3,15,9,0
2830,4,2,1,3,0,1,4,25.0,3,2,0,2,3,7,3,0
2831,9,2,7,2,0,4,6,66.7,2,1,1,0,7,16,12,0
2832,9,6,7,2,0,2,10,20.0,8,2,0,2,3,12,6,0
2833,3,1,1,1,1,1,2,50.0,1,1,0,1,3,6,4,0
2834,0,0,0,0,0,0,0,0.0,0,0,0,0,0,0,0,0
2835,0,0,0,0,0,0,0,0.0,0,0,0,0,0,0,0,0
2836,3,2,3,0,0,3,8,37.5,5,0,0,0,0,3,40,1
2837,52,32,22,25,5,24,67,35.8,43,39,3,36,28,80,23,1
2838,70,42,44,24,2,35,53,66.0,18,39,19,20,44,114,147,2
2839,40,27,18,17,5,17,38,44.7,21,27,1,26,11,51,16,0
2840,90,55,52,29,9,55,96,57.3,41,45,7,38,46,136,102,0
2841,42,23,14,22,6,16,44,36.4,28,40,4,36,20,62,29,1
2842,53,36,33,15,5,31,37,83.8,6,33,14,19,18,71,84,0
2843,32,19,25,7,0,11,18,61.1,7,27,15,12,20,52,120,3
2844,12,8,4,6,2,6,15,40.0,9,13,1,12,4,16,14,1
2845,15,6,4,7,4,6,30,20.0,24,11,0,11,7,22,10,0
2846,42,21,17,22,3,19,39,48.7,20,27,4,23,24,66,21,0
2847,62,35,15,34,13,20,42,47.6,22,20,2,18,12,74,16,1
2848,39,25,18,17,4,18,36,50.0,18,28,2,26,14,53,18,1
2849,41,22,29,7,5,23,33,69.7,10,23,16,7,10,51,52,1
2850,2,0,0,2,0,0,5,0.0,5,6,0,6,0,2,9,0
2851,6,3,1,2,3,1,9,11.1,8,0,0,0,0,6,1,0
2852,9,8,3,4,2,1,12,8.3,11,5,0,5,2,11,7,0
2853,12,8,3,6,3,6,18,33.3,12,4,0,4,2,14,5,0
2854,11,5,6,5,0,2,8,25.0,6,5,3,2,6,17,9,0
2855,6,5,5,1,0,3,6,50.0,3,4,1,3,2,8,17,0
2856,4,1,1,3,0,0,2,0.0,2,3,1,2,2,6,4,0
2857,5,3,2,3,0,3,6,50.0,3,7,1,6,3,8,0,0
2858,2,2,1,1,0,0,2,0.0,2,3,2,1,2,4,3,0
2859,1,1,0,1,0,1,2,50.0,1,1,0,1,0,1,2,0
2860,0,0,0,0,0,0,0,0.0,0,0,0,0,0,0,1,1
2861,2,2,2,0,0,1,2,50.0,1,2,0,2,0,2,0,0
2862,4,3,2,2,0,3,4,75.0,1,3,1,2,2,6,5,1
2863,4,3,3,1,0,0,1,0.0,1,1,1,0,2,6,5,0
2864,1,0,1,0,0,0,0,0.0,0,0,0,0,0,1,1,0
2865,1,1,1,0,0,1,1,100.0,0,0,0,0,0,1,17,3
2866,39,25,26,11,2,19,30,63.3,11,33,18,15,23,62,155,1
2867,46,25,16,21,9,20,58,34.5,38,29,2,27,16,62,41,0
2868,44,31,20,24,0,22,39,56.4,17,27,11,16,29,73,66,1
2869,107,66,39,62,6,46,101,45.5,55,62,10,52,35,142,52,1
2870,34,25,15,10,9,7,34,20.6,27,35,0,35,36,70,33,0
2871,67,45,43,22,2,30,82,36.6,52,26,4,22,40,107,63,0
2872,48,24,18,23,7,21,53,39.6,32,24,3,21,16,64,15,2
2873,16,5,3,10,3,6,15,40.0,9,10,2,8,3,19,15,0
2874,19,10,13,4,2,8,10,80.0,2,27,19,8,22,41,82,1
2875,10,8,5,4,1,4,11,36.4,7,19,14,5,14,24,98,1
2876,27,15,11,9,7,13,21,61.9,8,21,1,20,5,32,9,0
2877,44,24,16,26,2,16,29,55.2,13,27,10,17,30,74,54,0
2878,9,5,4,3,2,3,6,50.0,3,3,0,3,1,10,8,0
2879,19,8,5,8,6,7,22,31.8,15,12,0,12,7,26,18,0
2880,23,18,15,6,2,11,17,64.7,6,15,3,12,6,29,29,1
2881,27,11,11,15,1,11,23,47.8,12,11,0,11,8,35,6,0
2882,12,4,6,5,1,8,15,53.3,7,4,1,3,0,12,12,0
2883,16,9,8,6,2,9,17,52.9,8,15,6,9,10,26,7,0
2884,11,4,1,6,4,4,10,40.0,6,6,1,5,2,13,11,1
2885,7,5,1,5,1,1,3,33.3,2,2,0,2,3,10,4,0
2886,0,0,0,0,0,0,0,0.0,0,0,0,0,0,0,1,0
2887,2,2,1,1,0,1,5,20.0,4,1,0,1,0,2,0,0
2888,0,0,0,0,0,0,4,0.0,4,0,0,0,1,1,0,0
2889,1,1,0,1,0,1,1,100.0,0,1,0,1,0,1,0,0
2890,1,1,1,0,0,1,1,100.0,0,0,0,0,1,2,0,0
2891,97,59,39,52,6,50,121,41.3,71,60,14,46,33,130,55,2
2892,1,1,1,0,0,1,4,25.0,3,0,0,0,0,1,15,3
2893,28,15,9,15,4,8,27,29.6,19,23,7,16,9,37,44,0
2894,41,26,29,11,1,21,36,58.3,15,38,24,14,27,68,120,0
2895,50,31,30,15,5,25,45,55.6,20,24,7,17,27,77,87,2
2896,43,24,26,12,5,25,46,54.3,21,34,9,25,19,62,72,1
2897,46,29,20,21,5,22,43,51.2,21,33,0,33,19,65,7,1
2898,29,18,23,5,1,18,32,56.3,14,27,21,6,11,40,92,1
2899,40,23,23,11,6,17,57,29.8,40,20,0,20,7,47,17,0
2900,39,24,16,14,9,20,55,36.4,35,23,5,18,26,65,33,2
2901,52,28,18,26,8,22,51,43.1,29,26,2,24,16,68,18,0
2902,12,6,1,9,2,2,7,28.6,5,16,1,15,7,19,4,0
2903,47,27,32,11,4,32,55,58.2,23,27,4,23,17,64,45,0
2904,19,9,10,9,0,11,22,50.0,11,17,5,12,15,34,30,0
2905,6,4,2,3,1,3,5,60.0,2,8,3,5,3,9,3,0
2906,23,14,7,9,7,13,24,54.2,11,8,1,7,4,27,2,0
2907,9,4,2,7,0,2,9,22.2,7,6,0,6,6,15,3,0
2908,14,9,6,7,1,7,15,46.7,8,10,2,8,13,27,10,1
2909,20,12,17,2,1,13,21,61.9,8,6,4,2,2,22,20,0
2910,7,3,4,3,0,4,8,50.0,4,3,2,1,8,15,25,0
2911,8,7,6,2,0,4,7,57.1,3,5,3,2,8,16,33,0
2912,8,5,6,2,0,5,5,100.0,0,1,0,1,7,15,15,0
2913,0,0,0,0,0,0,1,0.0,1,0,0,0,0,0,3,0
2914,3,2,2,1,0,1,4,25.0,3,3,2,1,2,5,1,0
2915,6,3,3,3,0,2,5,40.0,3,10,7,3,5,11,26,0
2916,10,7,2,6,2,4,9,44.4,5,10,0,10,0,10,4,0
2917,4,3,1,3,0,2,5,40.0,3,4,0,4,3,7,0,0
2918,5,3,2,2,1,5,6,83.3,1,0,0,0,3,8,1,0
2919,0,0,0,0,0,0,0,0.0,0,1,0,1,1,1,0,0
2920,1,1,0,1,0,0,0,0.0,0,0,0,0,0,1,0,0
2921,2,1,0,2,0,1,2,50.0,1,0,0,0,0,2,0,0
2922,0,0,0,0,0,0,0,0.0,0,0,0,0,0,0,0,0
2923,1,0,1,0,0,1,1,100.0,0,0,0,0,0,1,1,0
2924,0,0,0,0,0,0,0,0.0,0,0,0,0,0,0,0,0
2925,0,0,0,0,0,0,1,0.0,1,0,0,0,0,0,19,2
2926,45,21,22,20,3,25,49,51.0,24,48,28,20,38,83,130,3
2927,55,37,29,15,11,26,53,49.1,27,37,1,36,15,70,12,0
2928,61,33,28,23,10,25,50,50.0,25,43,9,34,51,112,43,0
2929,34,22,22,12,0,16,26,61.5,10,38,23,15,14,48,107,3
2930,62,37,36,20,6,17,44,38.6,27,23,5,18,15,77,22,2
2931,34,17,16,17,1,14,31,45.2,17,20,1,19,16,50,8,1
2932,47,23,35,8,4,22,39,56.4,17,20,8,12,15,62,83,1
2933,25,16,12,8,5,9,25,36.0,16,13,1,12,11,36,22,0
2934,22,13,13,9,0,9,18,50.0,9,21,9,12,11,33,94,0
2935,27,15,18,7,2,13,16,81.3,3,14,4,10,10,37,34,0
2936,12,7,5,6,1,6,26,23.1,20,16,2,14,34,46,10,0
2937,46,26,27,18,1,17,39,43.6,22,20,6,14,11,57,27,2
2938,19,9,6,9,4,10,19,52.6,9,4,0,4,4,23,1,0
2939,11,6,9,2,0,8,18,44.4,10,5,2,3,18,29,29,0
2940,14,8,7,5,2,7,19,36.8,12,12,4,8,4,18,11,0
2941,7,5,2,5,0,2,6,33.3,4,11,0,11,0,7,13,0
2942,7,5,2,5,0,4,7,57.1,3,6,1,5,2,9,12,0
2943,19,12,11,6,2,12,20,60.0,8,14,4,10,7,26,21,0
2944,17,12,10,5,2,6,14,42.9,8,11,4,7,4,21,33,2
2945,8,7,7,1,0,6,6,100.0,0,8,8,0,11,19,48,0
2946,7,4,6,0,1,3,6,50.0,3,9,7,2,3,10,29,1
2947,5,1,2,3,0,2,4,50.0,2,12,1,11,1,6,2,1
2948,19,14,12,7,0,6,12,50.0,6,9,3,6,13,32,8,0
2949,16,13,11,5,0,8,16,50.0,8,4,2,2,1,17,17,1
2950,0,0,0,0,0,0,0,0.0,0,1,0,1,0,0,2,0
2951,2,1,1,1,0,1,3,33.3,2,3,0,3,3,5,2,0
2952,4,4,1,3,0,2,4,50.0,2,2,0,2,0,4,5,0
2953,4,1,2,0,2,2,8,25.0,6,4,0,4,1,5,1,0
2954,1,0,1,0,0,1,1,100.0,0,1,0,1,0,1,4,0
2955,2,2,0,2,0,1,1,100.0,0,1,1,0,0,2,2,0
2956,0,0,0,0,0,0,0,0.0,0,0,0,0,0,0,1,0
2957,0,0,0,0,0,0,0,0.0,0,0,0,0,0,0,0,0
2958,0,0,0,0,0,0,1,0.0,1,0,0,0,0,0,4,0
2959,1,1,1,0,0,0,0,0.0,0,0,0,0,0,1,0,0
2960,32,21,22,9,1,17,40,42.5,23,39,14,25,30,62,108,2
2961,47,30,39,6,2,23,40,57.5,17,32,16,16,45,92,132,4
2962,55,34,21,30,4,23,62,37.1,39,24,5,19,25,80,30,2
2963,50,25,14,25,11,14,34,41.2,20,35,5,30,10,60,46,0
2964,83,46,43,36,4,38,84,45.2,46,24,6,18,28,111,43,1
2965,18,14,8,7,3,6,27,22.2,21,19,3,16,4,22,7,0
2966,29,18,15,8,6,12,24,50.0,12,32,4,28,13,42,64,0
2967,51,33,26,20,5,26,41,63.4,15,32,10,22,6,57,26,1
2968,18,9,8,6,4,8,23,34.8,15,9,0,9,3,21,3,0
2969,20,12,14,6,0,14,21,66.7,7,31,18,13,28,48,74,2
2970,0,0,0,0,0,0,1,0.0,1,0,0,0,0,0,10,2
2971,36,17,19,12,5,21,37,56.8,16,24,6,18,26,62,45,0
2972,14,6,4,10,0,4,12,33.3,8,13,0,13,5,19,4,1
2973,0,0,0,0,0,0,1,0.0,1,0,0,0,0,0,9,2
2974,29,16,20,9,0,17,22,77.3,5,16,10,6,11,40,68,2
2975,29,19,12,10,7,6,21,28.6,15,18,0,18,4,33,7,0
2976,13,6,10,3,0,8,22,36.4,14,7,1,6,5,18,10,0
2977,13,10,4,6,3,9,17,52.9,8,4,0,4,2,15,6,0
2978,12,8,6,5,1,6,15,40.0,9,5,0,5,6,18,4,0
2979,7,3,2,5,0,3,9,33.3,6,6,3,3,6,13,13,1
2980,18,10,16,1,1,10,14,71.4,4,6,5,1,8,26,28,1
2981,13,8,8,4,1,5,11,45.5,6,5,1,4,7,20,9,1
2982,0,0,0,0,0,0,1,0.0,1,0,0,0,0,0,1,2
2983,7,3,2,5,0,1,5,20.0,4,4,1,3,1,8,4,0
2984,0,0,0,0,0,0,1,0.0,1,0,0,0,0,0,1,0
2985,6,4,3,2,1,4,7,57.1,3,1,0,1,1,7,4,1
2986,8,5,6,1,1,4,5,80.0,1,6,0,6,1,9,3,0
2987,5,2,2,3,0,1,3,33.3,2,3,0,3,3,8,2,0
2988,5,3,2,3,0,1,3,33.3,2,1,0,1,1,6,8,0
2989,3,2,1,0,2,0,3,0.0,3,0,0,0,0,3,0,0
2990,3,1,1,2,0,2,2,100.0,0,3,2,1,0,3,1,1
2991,1,1,0,1,0,1,1,100.0,0,0,0,0,0,1,0,0
2992,5,2,4,1,0,2,3,66.7,1,2,0,2,1,6,3,0
2993,1,1,0,1,0,0,1,0.0,1,0,0,0,0,1,2,0
2994,1,0,1,0,0,1,1,100.0,0,0,0,0,0,1,2,0
2995,1,1,1,0,0,0,0,0.0,0,0,0,0,0,1,1,0
2996,3,3,2,0,1,1,3,33.3,2,0,0,0,0,3,0,0
2997,0,0,0,0,0,0,0,0.0,0,0,0,0,0,0,0,0
2998,0,0,0,0,0,0,2,0.0,2,0,0,0,0,0,0,0
2999,0,0,0,0,0,0,0,0.0,0,0,0,0,1,1,9,4
3000,4,1,1,1,2,4,9,44.4,5,4,0,4,2,6,2,0
3001,39,24,12,16,11,16,48,33.3,32,29,11,18,23,62,30,2
3002,52,36,28,15,9,29,50,58.0,21,21,5,16,27,79,38,0
3003,22,12,14,6,2,9,17,52.9,8,29,26,3,23,45,100,1
3004,51,28,18,24,9,28,51,54.9,23,32,8,24,15,66,22,2
3005,98,57,39,43,16,43,89,48.3,46,27,6,21,40,138,25,2
3006,29,19,14,9,6,17,34,50.0,17,28,4,24,12,41,28,2
3007,19,11,10,7,2,11,17,64.7,6,29,19,10,17,36,58,1
3008,26,13,7,9,10,15,36,41.7,21,7,0,7,6,32,3,0
3009,34,16,12,13,9,7,25,28.0,18,27,2,25,10,44,13,1
3010,24,18,17,7,0,14,22,63.6,8,19,10,9,12,36,51,2
3011,19,14,2,7,10,6,13,46.2,7,11,0,11,5,24,4,1
3012,25,15,4,12,9,6,20,30.0,14,12,2,10,5,30,16,0
3013,34,23,17,14,3,23,42,54.8,19,8,2,6,11,45,21,2
3014,10,8,5,3,2,5,13,38.5,8,5,0,5,4,14,10,0
3015,12,10,4,7,1,4,13,30.8,9,7,0,7,5,17,2,0
3016,15,10,9,2,4,6,21,28.6,15,10,3,7,5,20,11,1
3017,22,14,14,8,0,10,25,40.0,15,15,6,9,20,42,25,0
3018,12,8,6,5,1,8,15,53.3,7,17,4,13,14,26,28,0
3019,0,0,0,0,0,0,0,0.0,0,0,0,0,0,0,0,0
3020,18,8,11,4,3,11,24,45.8,13,3,0,3,4,22,9,1
3021,0,0,0,0,0,0,0,0.0,0,0,0,0,0,0,2,0
3022,13,8,6,6,1,6,7,85.7,1,1,0,1,3,16,0,0
3023,5,5,4,1,0,4,7,57.1,3,4,0,4,4,9,2,0
3024,0,0,0,0,0,0,2,0.0,2,1,0,1,0,0,0,0
3025,2,2,0,2,0,1,2,50.0,1,0,0,0,0,2,0,0
3026,0,0,0,0,0,0,0,0.0,0,0,0,0,0,0,0,0
3027,0,0,0,0,0,0,0,0.0,0,0,0,0,0,0,0,0
3028,61,39,19,36,6,30,66,45.5,36,35,7,28,37,98,31,1
3029,4,3,1,2,1,1,11,9.1,10,18,0,18,8,12,1,0
3030,42,30,14,22,6,15,42,35.7,27,37,3,34,21,63,14,0
3031,34,17,10,13,11,16,54,29.6,38,29,1,28,11,45,8,0
3032,34,25,18,14,2,17,26,65.4,9,27,14,13,51,85,81,2
3033,38,27,11,20,7,12,30,40.0,18,39,13,26,47,85,41,0
3034,1,1,1,0,0,1,1,100.0,0,0,0,0,1,2,5,3
3035,22,8,15,6,1,10,27,37.0,17,26,13,13,30,52,106,4
3036,60,41,20,30,10,32,70,45.7,38,29,2,27,35,95,37,1
3037,12,4,3,8,1,5,13,38.5,8,10,0,10,3,15,4,0
3038,37,23,12,20,5,12,36,33.3,24,21,0,21,9,46,3,0
3039,57,41,27,21,9,29,47,61.7,18,19,2,17,11,68,40,0
3040,56,26,22,32,2,26,48,54.2,22,21,4,17,21,77,36,2
3041,32,22,22,7,3,22,39,56.4,17,18,6,12,30,62,55,0
3042,35,21,10,20,5,15,29,51.7,14,8,2,6,11,46,7,0
3043,37,20,17,16,4,27,49,55.1,22,17,2,15,16,53,22,0
3044,0,0,0,0,0,0,0,0.0,0,1,0,1,0,0,5,1
3045,27,12,11,13,3,17,26,65.4,9,21,12,9,22,49,44,0
3046,17,12,8,5,4,9,20,45.0,11,11,0,11,13,30,20,0
3047,13,7,3,7,3,6,9,66.7,3,8,2,6,6,19,9,0
3048,9,6,2,5,2,3,7,42.9,4,6,0,6,2,11,2,0
3049,9,7,5,3,1,2,7,28.6,5,4,1,3,4,13,4,0
3050,3,3,0,2,1,1,4,25.0,3,1,0,1,1,4,2,0
3051,7,4,2,3,2,3,8,37.5,5,4,0,4,0,7,0,0
3052,10,8,6,3,1,7,9,77.8,2,3,0,3,1,11,5,0
3053,3,1,0,3,0,2,4,50.0,2,1,1,0,3,6,0,0
3054,2,2,0,1,1,1,2,50.0,1,2,0,2,0,2,0,0
3055,2,2,0,2,0,1,2,50.0,1,1,0,1,0,2,0,0
3056,0,0,0,0,0,0,0,0.0,0,1,0,1,0,0,0,0
3057,0,0,0,0,0,0,0,0.0,0,0,0,0,0,0,0,0
3058,57,34,33,22,2,32,63,50.8,31,58,34,24,53,110,139,3
3059,78,51,39,28,11,30,56,53.6,26,27,6,21,28,106,75,1
3060,97,55,57,34,6,47,80,58.8,33,28,1,27,40,137,69,0
3061,0,0,0,0,0,0,1,0.0,1,0,0,0,0,0,18,3
3062,31,18,18,13,0,12,24,50.0,12,28,21,7,41,72,93,0
3063,46,29,14,18,14,18,70,25.7,52,33,1,32,9,55,8,0
3064,49,27,18,26,5,24,58,41.4,34,19,1,18,18,67,18,0
3065,96,67,51,41,4,49,129,38.0,80,61,11,50,43,139,64,3
3066,55,39,8,40,7,20,49,40.8,29,24,1,23,27,82,19,0
3067,24,16,6,13,5,10,25,40.0,15,19,7,12,7,31,28,0
3068,8,7,0,3,5,3,11,27.3,8,13,3,10,2,10,18,0
3069,21,10,7,9,5,11,26,42.3,15,14,1,13,2,23,10,0
3070,21,15,7,8,6,7,28,25.0,21,14,5,9,10,31,13,0
3071,43,27,17,24,2,21,36,58.3,15,16,2,14,9,52,28,2
3072,28,18,8,10,10,10,29,34.5,19,14,0,14,9,37,6,0
3073,19,11,11,7,1,8,12,66.7,4,6,3,3,13,32,26,0
3074,0,0,0,0,0,0,0,0.0,0,0,0,0,0,0,0,0
3075,0,0,0,0,0,0,3,0.0,3,3,0,3,0,0,0,0
3076,1,1,1,0,0,0,2,0.0,2,2,0,2,5,6,9,1
3077,1,1,0,1,0,1,3,33.3,2,2,1,1,3,4,2,0
3078,3,1,0,2,1,2,4,50.0,2,2,0,2,0,3,0,0
3079,0,0,0,0,0,0,3,0.0,3,2,1,1,0,0,1,0
3080,0,0,0,0,0,0,0,0.0,0,0,0,0,0,0,0,0
3081,0,0,0,0,0,0,1,0.0,1,1,1,0,1,1,0,0
3082,1,0,0,0,1,1,2,50.0,1,0,0,0,1,2,0,0
3083,3,0,3,0,0,3,4,75.0,1,1,0,1,0,3,11,2
3084,36,25,27,7,2,17,31,54.8,14,20,14,6,36,72,97,1
3085,26,15,6,13,7,8,26,30.8,18,16,0,16,9,35,4,0
3086,26,13,4,15,7,14,32,43.8,18,23,6,17,18,44,28,1
3087,89,49,39,45,5,43,81,53.1,38,34,5,29,35,124,60,0
3088,72,47,34,25,13,31,60,51.7,29,33,6,27,32,104,77,0
3089,63,42,31,19,13,30,52,57.7,22,24,5,19,15,78,37,0
3090,32,18,9,15,8,14,36,38.9,22,17,1,16,8,40,8,0
3091,32,22,24,8,0,16,31,51.6,15,25,15,10,35,67,116,5
3092,49,32,29,18,2,22,43,51.2,21,33,12,21,37,86,33,0
3093,29,20,12,15,2,24,32,75.0,8,16,8,8,21,50,49,1
3094,19,11,6,9,4,4,15,26.7,11,10,1,9,5,24,5,0
3095,12,8,4,7,1,5,21,23.8,16,7,2,5,3,15,5,0
3096,54,36,19,20,15,20,54,37.0,34,32,0,32,5,59,5,0
3097,22,16,7,13,2,12,20,60.0,8,14,3,11,15,37,25,0
3098,10,6,3,4,3,7,20,35.0,13,9,2,7,5,15,6,0
3099,4,3,2,2,0,2,7,28.6,5,2,0,2,6,10,1,0
3100,1,1,0,1,0,1,4,25.0,3,0,0,0,2,3,4,0
3101,6,2,6,0,0,2,5,40.0,3,2,0,2,1,7,3,0
3102,0,0,0,0,0,0,0,0.0,0,0,0,0,0,0,0,0
3103,1,1,1,0,0,0,1,0.0,1,0,0,0,0,1,0,0
3104,6,2,1,4,1,3,4,75.0,1,0,0,0,2,8,0,0
3105,1,0,0,1,0,0,1,0.0,1,1,0,1,0,1,0,0
3106,1,1,0,1,0,0,0,0.0,0,0,0,0,1,2,0,0
3107,0,0,0,0,0,0,0,0.0,0,0,0,0,1,1,0,0
3108,0,0,0,0,0,0,0,0.0,0,0,0,0,0,0,0,0
3109,0,0,0,0,0,0,0,0.0,0,0,0,0,0,0,0,0
3110,0,0,0,0,0,0,0,0.0,0,0,0,0,0,0,0,0
3111,0,0,0,0,0,0,2,0.0,2,0,0,0,0,0,9,3
3112,62,30,44,16,2,38,52,73.1,14,43,22,21,37,99,77,2
3113,69,38,28,30,11,37,63,58.7,26,46,12,34,42,111,46,0
3114,58,28,35,17,6,34,56,60.7,22,34,15,19,38,96,97,1
3115,42,29,13,23,6,20,40,50.0,20,21,10,11,18,60,37,0
3116,18,7,6,10,2,10,20,50.0,10,26,2,24,8,26,4,0
3117,26,19,12,7,7,12,31,38.7,19,34,5,29,20,46,16,0
3118,7,4,0,5,2,3,12,25.0,9,14,1,13,3,10,15,0
3119,18,12,8,4,6,11,30,36.7,19,20,2,18,6,24,8,1
3120,36,25,15,16,5,23,34,67.6,11,27,13,14,29,65,39,0
3121,36,28,18,9,9,25,35,71.4,10,30,9,21,16,52,26,1
3122,31,20,17,12,2,12,23,52.2,11,19,11,8,12,43,47,1
3123,41,19,16,22,3,21,30,70.0,9,15,1,14,11,52,15,0
3124,16,7,2,7,7,6,7,85.7,1,12,1,11,12,28,7,0
3125,12,9,4,7,1,3,11,27.3,8,10,0,10,3,15,6,0
3126,8,6,3,4,1,4,10,40.0,6,4,0,4,3,11,3,0
3127,9,3,6,2,1,6,8,75.0,2,7,1,6,4,13,1,0
3128,12,5,3,6,3,1,5,20.0,4,4,1,3,5,17,7,0
3129,7,5,4,3,0,3,7,42.9,4,4,1,3,8,15,16,0
3130,14,5,6,6,2,7,11,63.6,4,7,3,4,3,17,9,0
3131,7,6,5,1,1,4,11,36.4,7,4,0,4,6,13,15,1
3132,3,2,1,1,1,3,4,75.0,1,5,0,5,3,6,0,0
3133,4,1,0,3,1,1,1,100.0,0,2,1,1,3,7,0,0
3134,1,0,1,0,0,0,0,0.0,0,1,0,1,2,3,5,0
3135,1,0,0,1,0,1,1,100.0,0,0,0,0,0,1,0,0
3136,0,0,0,0,0,0,0,0.0,0,0,0,0,0,0,0,0
3137,0,0,0,0,0,0,1,0.0,1,0,0,0,0,0,0,0
3138,91,64,39,37,15,38,107,35.5,69,40,9,31,48,139,26,2
3139,0,0,0,0,0,0,0,0.0,0,0,0,0,0,0,16,0
3140,22,16,16,5,1,14,20,70.0,6,23,18,5,12,34,98,1
3141,19,12,8,9,2,5,17,29.4,12,22,3,19,8,27,9,0
3142,43,24,29,8,6,23,40,57.5,17,35,16,19,40,83,61,0
3143,54,34,23,22,9,22,49,44.9,27,25,8,17,28,82,43,0
3144,26,11,19,6,1,18,22,81.8,4,27,14,13,18,44,94,1
3145,28,14,18,6,4,12,38,31.6,26,15,1,14,8,36,9,0
3146,33,21,13,11,9,14,33,42.4,19,26,9,17,10,43,18,0
3147,28,15,4,16,8,17,46,37.0,29,13,3,10,7,35,1,0
3148,34,18,12,14,8,19,37,51.4,18,16,6,10,17,51,29,1
3149,17,11,8,7,2,9,19,47.4,10,17,6,11,16,33,17,1
3150,10,4,5,3,2,9,16,56.3,7,12,9,3,15,25,26,1
3151,9,7,1,6,2,5,7,71.4,2,7,0,7,1,10,3,0
3152,30,20,14,12,4,9,22,40.9,13,12,3,9,14,44,18,2
3153,9,7,6,3,0,3,7,42.9,4,6,5,1,12,21,37,0
3154,10,6,6,4,0,6,11,54.5,5,8,2,6,10,20,3,0
3155,8,7,5,2,1,2,9,22.2,7,5,1,4,2,10,5,0
3156,4,3,0,1,3,1,4,25.0,3,2,0,2,1,5,2,1
3157,5,4,3,1,1,4,9,44.4,5,3,0,3,5,10,9,0
3158,8,5,1,2,5,3,9,33.3,6,0,0,0,3,11,1,1
3159,5,3,0,2,3,1,3,33.3,2,3,2,1,5,10,6,0
3160,9,6,4,5,0,3,11,27.3,8,4,1,3,4,13,4,0
3161,14,9,2,10,2,6,7,85.7,1,5,1,4,6,20,11,0
3162,0,0,0,0,0,0,3,0.0,3,3,0,3,2,2,5,0
3163,11,4,3,5,3,4,11,36.4,7,1,0,1,0,11,0,0
3164,5,2,0,2,3,1,7,14.3,6,4,0,4,2,7,0,0
3165,0,0,0,0,0,0,1,0.0,1,0,0,0,0,0,1,1
3166,1,1,0,1,0,1,5,20.0,4,3,1,2,5,6,7,0
3167,4,3,2,2,0,1,8,12.5,7,5,0,5,4,8,0,0
3168,1,0,0,1,0,0,0,0.0,0,1,0,1,0,1,1,0
3169,0,0,0,0,0,0,0,0.0,0,0,0,0,0,0,0,0
3170,0,0,0,0,0,0,0,0.0,0,0,0,0,0,0,0,0
3171,0,0,0,0,0,0,0,0.0,0,0,0,0,1,1,3,0
3172,0,0,0,0,0,0,0,0.0,0,0,0,0,0,0,0,0
3173,1,1,1,0,0,1,1,100.0,0,0,0,0,0,1,10,3
3174,64,38,25,31,8,44,69,63.8,25,38,13,25,24,88,59,2
3175,24,14,12,11,1,15,30,50.0,15,43,30,13,23,47,115,1
3176,33,22,9,21,3,17,38,44.7,21,41,4,37,20,53,34,0
3177,32,20,15,14,3,19,35,54.3,16,30,17,13,37,69,61,0
3178,60,39,25,26,9,31,74,41.9,43,30,7,23,25,85,36,0
3179,53,31,27,23,3,27,45,60.0,18,35,5,30,26,79,46,0
3180,6,4,1,3,2,2,10,20.0,8,5,1,4,3,9,3,0
3181,37,20,13,20,4,20,46,43.5,26,20,6,14,32,69,21,1
3182,21,14,8,10,3,8,18,44.4,10,12,1,11,12,33,18,0
3183,18,10,5,12,1,10,23,43.5,13,21,4,17,16,34,8,1
3184,23,14,6,13,4,11,19,57.9,8,22,1,21,8,31,11,0
3185,28,19,12,11,5,14,22,63.6,8,13,3,10,3,31,5,1
3186,25,14,4,16,5,11,34,32.4,23,14,0,14,9,34,10,1
3187,24,18,10,10,4,15,20,75.0,5,13,2,11,7,31,8,0
3188,29,18,10,13,6,16,20,80.0,4,11,4,7,14,43,14,1
3189,8,4,1,2,5,2,9,22.2,7,4,0,4,4,12,3,0
3190,21,12,13,8,0,9,17,52.9,8,13,8,5,13,34,32,2
3191,9,8,5,3,1,4,6,66.7,2,7,2,5,11,20,32,3
3192,6,5,2,2,2,3,9,33.3,6,2,0,2,5,11,11,0
3193,21,10,4,12,5,5,11,45.5,6,11,2,9,4,25,7,0
3194,1,0,0,1,0,1,1,100.0,0,2,1,1,2,3,1,0
3195,0,0,0,0,0,0,0,0.0,0,0,0,0,0,0,1,0
3196,1,1,1,0,0,1,1,100.0,0,1,0,1,0,1,3,0
3197,3,1,0,2,1,1,2,50.0,1,1,0,1,0,3,0,0
3198,6,2,4,2,0,4,9,44.4,5,2,1,1,0,6,0,0
3199,0,0,0,0,0,0,0,0.0,0,1,0,1,0,0,0,0
3200,0,0,0,0,0,0,2,0.0,2,0,0,0,0,0,10,1
3201,22,14,4,11,7,7,26,26.9,19,30,5,25,9,31,26,0
3202,79,50,55,23,1,49,67,73.1,18,38,15,23,51,130,91,0
3203,33,21,25,7,1,17,30,56.7,13,21,13,8,13,46,95,1
3204,47,20,22,19,6,26,49,53.1,23,17,3,14,36,83,46,0
3205,38,22,19,13,6,18,39,46.2,21,20,4,16,13,51,25,0
3206,28,16,8,17,3,13,37,35.1,24,31,4,27,12,40,4,0
3207,33,22,16,13,4,13,19,68.4,6,28,18,10,25,58,93,1
3208,21,18,5,11,5,11,29,37.9,18,14,2,12,6,27,6,0
3209,48,31,18,25,5,13,32,40.6,19,21,4,17,30,78,25,0
3210,14,8,2,10,2,6,17,35.3,11,21,6,15,13,27,11,0
3211,25,11,9,14,2,11,32,34.4,21,6,1,5,11,36,8,0
3212,24,16,8,13,3,13,21,61.9,8,7,2,5,16,40,35,0
3213,23,11,13,6,4,15,23,65.2,8,9,2,7,11,34,34,2
3214,14,8,3,5,6,3,12,25.0,9,11,2,9,5,19,8,0
3215,21,16,6,13,2,13,20,65.0,7,8,3,5,7,28,13,2
3216,23,12,9,12,2,14,26,53.8,12,16,4,12,15,38,18,0
3217,33,21,11,19,3,13,19,68.4,6,17,3,14,13,46,12,0
3218,8,7,4,1,3,4,7,57.1,3,9,0,9,8,16,3,0
3219,13,12,7,5,1,8,20,40.0,12,4,0,4,6,19,14,0
3220,16,10,13,3,0,8,12,66.7,4,11,5,6,11,27,35,0
3221,7,5,4,2,1,0,8,0.0,8,2,0,2,1,8,1,0
3222,23,14,6,14,3,13,25,52.0,12,10,2,8,11,34,11,1
3223,2,1,0,2,0,0,3,0.0,3,4,0,4,3,5,1,0
3224,0,0,0,0,0,0,3,0.0,3,2,0,2,1,1,1,0
3225,0,0,0,0,0,0,0,0.0,0,0,0,0,0,0,0,0
3226,4,3,2,2,0,1,2,50.0,1,0,0,0,2,6,2,0
3227,2,1,0,2,0,1,3,33.3,2,6,0,6,1,3,3,0
3228,1,1,1,0,0,1,2,50.0,1,0,0,0,0,1,2,0
3229,0,0,0,0,0,0,0,0.0,0,1,1,0,0,0,0,0
3230,2,0,0,2,0,1,2,50.0,1,1,0,1,2,4,0,0
3231,0,0,0,0,0,0,0,0.0,0,0,0,0,0,0,0,0
3232,0,0,0,0,0,0,0,0.0,0,0,0,0,0,0,0,0
3233,0,0,0,0,0,0,1,0.0,1,0,0,0,1,1,19,3
3234,64,35,36,23,5,26,45,57.8,19,51,32,19,39,103,109,2
3235,33,15,11,14,8,10,36,27.8,26,23,1,22,14,47,7,0
3236,65,41,38,23,4,44,64,68.8,20,47,25,22,55,120,116,1
3237,61,39,18,34,9,33,61,54.1,28,21,7,14,14,75,33,0
3238,54,36,19,21,14,25,62,40.3,37,33,4,29,20,74,6,0
3239,32,17,21,8,3,20,45,44.4,25,34,12,22,25,57,36,0
3240,56,35,36,16,4,33,59,55.9,26,25,5,20,21,77,51,1
3241,44,28,28,14,2,24,38,63.2,14,27,19,8,35,79,112,2
3242,10,9,4,4,2,6,16,37.5,10,5,1,4,4,14,4,0
3243,25,12,10,9,6,7,21,33.3,14,13,0,13,7,32,7,0
3244,28,11,9,10,9,17,37,45.9,20,15,2,13,6,34,7,0
3245,39,27,17,19,3,22,32,68.8,10,21,3,18,33,72,32,1
3246,16,10,5,4,7,8,20,40.0,12,8,2,6,3,19,13,0
3247,33,23,12,18,3,10,22,45.5,12,26,5,21,15,48,30,0
3248,11,5,6,3,2,8,11,72.7,3,9,3,6,10,21,25,0
3249,19,13,6,9,4,5,13,38.5,8,5,1,4,6,25,9,0
3250,5,4,2,3,0,2,8,25.0,6,5,2,3,6,11,7,0
3251,13,8,11,2,0,6,10,60.0,4,8,3,5,10,23,10,0
3252,2,2,1,1,0,0,2,0.0,2,4,3,1,4,6,9,0
3253,9,7,3,5,1,6,11,54.5,5,3,1,2,2,11,8,0
3254,7,7,5,2,0,4,11,36.4,7,2,0,2,2,9,9,0
3255,0,0,0,0,0,0,0,0.0,0,1,0,1,1,1,1,0
3256,5,3,2,1,2,3,9,33.3,6,1,0,1,1,6,1,0
3257,2,0,0,1,1,0,2,0.0,2,6,1,5,4,6,5,0
3258,1,0,0,1,0,0,1,0.0,1,3,0,3,2,3,5,0
3259,2,1,1,0,1,0,0,0.0,0,2,1,1,1,3,0,0
3260,3,3,1,1,1,0,1,0.0,1,0,0,0,1,4,0,0
3261,1,1,1,0,0,1,1,100.0,0,0,0,0,0,1,0,0
3262,2,0,2,0,0,2,4,50.0,2,0,0,0,0,2,6,1
3263,31,18,14,9,8,13,44,29.5,31,31,2,29,22,53,39,2
3264,30,17,19,6,5,24,37,64.9,13,40,23,17,31,61,90,2
3265,5,4,2,2,1,2,5,40.0,3,13,2,11,4,9,4,0
3266,39,21,23,10,6,25,40,62.5,15,31,5,26,19,58,49,0
3267,20,10,4,11,5,8,19,42.1,11,18,1,17,14,34,12,0
3268,32,19,23,7,2,16,28,57.1,12,30,20,10,33,65,77,2
3269,52,33,21,25,6,29,46,63.0,17,15,6,9,34,86,33,1
3270,50,35,23,17,10,23,47,48.9,24,17,3,14,19,69,20,0
3271,14,9,3,8,3,6,14,42.9,8,21,4,17,9,23,17,0
3272,30,14,16,13,1,12,28,42.9,16,13,1,12,6,36,9,0
3273,32,18,11,14,7,10,33,30.3,23,30,1,29,14,46,8,0
3274,32,22,23,8,1,22,28,78.6,6,18,10,8,13,45,49,0
3275,18,12,12,6,0,8,15,53.3,7,19,9,10,18,36,51,0
3276,28,21,14,12,2,22,32,68.8,10,12,1,11,15,43,65,1
3277,24,12,12,8,4,9,24,37.5,15,9,4,5,9,33,27,1
3278,19,10,7,9,3,9,12,75.0,3,15,7,8,27,46,19,0
3279,7,3,3,4,0,4,7,57.1,3,9,2,7,11,18,17,0
3280,21,9,17,3,1,14,19,73.7,5,11,3,8,10,31,13,0
3281,15,7,5,6,4,11,18,61.1,7,4,0,4,10,25,5,0
3282,7,5,2,3,2,3,8,37.5,5,8,0,8,0,7,4,0
3283,13,7,2,9,2,6,11,54.5,5,3,1,2,5,18,2,0
3284,2,2,1,0,1,1,1,100.0,0,0,0,0,0,2,0,0
3285,1,1,0,0,1,0,2,0.0,2,2,1,1,4,5,0,0
3286,0,0,0,0,0,0,0,0.0,0,0,0,0,0,0,1,0
3287,1,1,1,0,0,1,1,100.0,0,1,0,1,0,1,0,0
3288,0,0,0,0,0,0,1,0.0,1,1,0,1,0,0,1,0
3289,1,1,1,0,0,0,1,0.0,1,0,0,0,1,2,0,0
3290,0,0,0,0,0,0,0,0.0,0,0,0,0,0,0,0,0
3291,0,0,0,0,0,0,3,0.0,3,0,0,0,0,0,19,1
3292,50,30,39,11,0,26,44,59.1,18,44,33,11,42,92,158,1
3293,40,24,31,9,0,15,24,62.5,9,42,27,15,23,63,120,1
3294,29,15,6,11,12,9,15,60.0,6,11,4,7,3,32,35,0
3295,66,32,40,19,7,38,86,44.2,48,37,4,33,26,92,33,0
3296,41,24,15,20,6,27,77,35.1,50,37,13,24,27,68,33,0
3297,70,34,31,33,6,29,61,47.5,32,34,4,30,27,97,33,1
3298,16,10,3,8,5,7,22,31.8,15,13,0,13,8,24,16,1
3299,18,12,8,7,3,9,17,52.9,8,32,13,19,19,37,38,0
3300,53,40,26,20,7,29,52,55.8,23,22,5,17,26,79,32,0
3301,32,12,16,15,1,13,27,48.1,14,30,14,16,20,52,43,0
3302,36,21,13,19,4,16,33,48.5,17,14,7,7,4,40,13,0
3303,22,14,5,12,5,15,21,71.4,6,16,4,12,4,26,17,0
3304,14,4,6,6,2,8,23,34.8,15,21,1,20,4,18,2,0
3305,36,24,16,16,4,13,23,56.5,10,11,3,8,9,45,35,0
3306,22,15,14,4,4,9,23,39.1,14,22,11,11,22,44,41,1
3307,14,8,5,6,3,7,20,35.0,13,8,2,6,5,19,8,0
3308,9,8,1,5,3,3,12,25.0,9,9,1,8,1,10,2,0
3309,4,2,4,0,0,3,6,50.0,3,7,0,7,8,12,17,0
3310,12,9,6,6,0,8,15,53.3,7,8,1,7,6,18,8,0
3311,11,8,2,7,2,2,5,40.0,3,6,1,5,0,11,2,0
3312,5,3,1,3,1,3,9,33.3,6,4,0,4,5,10,5,0
3313,4,3,3,1,0,1,3,33.3,2,3,0,3,1,5,0,0
3314,4,4,2,1,1,1,1,100.0,0,0,0,0,0,4,0,0
3315,4,2,2,2,0,3,4,75.0,1,0,0,0,4,8,3,0
3316,0,0,0,0,0,0,0,0.0,0,0,0,0,0,0,2,0
3317,37,20,16,15,6,14,63,22.2,49,36,8,28,33,70,28,1
3318,0,0,0,0,0,0,1,0.0,1,0,0,0,0,0,16,1
3319,81,52,45,25,11,48,96,50.0,48,47,21,26,44,125,60,0
3320,12,4,3,4,5,3,7,42.9,4,9,2,7,5,17,11,0
3321,48,29,31,13,4,20,33,60.6,13,51,29,22,27,75,65,0
3322,20,16,10,5,5,9,21,42.9,12,18,2,16,4,24,5,0
3323,36,22,16,17,3,20,67,29.9,47,19,1,18,13,49,23,0
3324,49,30,39,8,2,28,51,54.9,23,31,20,11,29,78,123,1
3325,28,17,20,6,2,16,34,47.1,18,21,7,14,23,51,53,0
3326,28,16,13,10,5,21,32,65.6,11,19,7,12,24,52,37,0
3327,12,6,3,5,4,6,16,37.5,10,11,0,11,2,14,10,0
3328,16,12,11,5,0,6,17,35.3,11,25,20,5,12,28,106,2
3329,24,17,8,12,4,14,35,40.0,21,10,0,10,3,27,7,0
3330,34,22,23,9,2,15,25,60.0,10,13,9,4,15,49,67,0
3331,16,12,11,5,0,10,15,66.7,5,13,9,4,18,34,50,0
3332,29,16,19,6,4,17,34,50.0,17,17,4,13,8,37,27,0
3333,26,17,18,4,4,11,25,44.0,14,20,7,13,11,37,25,0
3334,28,15,17,7,4,9,22,40.9,13,15,3,12,14,42,6,0
3335,21,15,10,7,4,15,29,51.7,14,7,2,5,8,29,11,0
3336,13,11,8,4,1,4,9,44.4,5,11,1,10,2,15,2,0
3337,0,0,0,0,0,0,0,0.0,0,0,0,0,0,0,0,0
3338,19,10,8,8,3,6,21,28.6,15,12,3,9,7,26,8,0
3339,17,7,10,6,1,11,19,57.9,8,9,4,5,3,20,15,0
3340,1,0,0,0,1,1,2,50.0,1,3,0,3,0,1,0,0
3341,9,5,6,2,1,2,6,33.3,4,2,0,2,2,11,6,0
3342,3,3,2,0,1,1,1,100.0,0,3,0,3,0,3,0,0
3343,4,2,2,2,0,1,3,33.3,2,3,2,1,1,5,3,0
3344,7,2,2,2,3,1,6,16.7,5,2,0,2,0,7,1,0
3345,0,0,0,0,0,0,0,0.0,0,0,0,0,0,0,0,0
3346,0,0,0,0,0,0,0,0.0,0,0,0,0,0,0,0,0
3347,1,1,1,0,0,1,1,100.0,0,0,0,0,0,1,1,0
3348,47,30,33,14,0,28,46,60.9,18,45,32,13,28,75,113,0
3349,87,50,49,30,8,47,72,65.3,25,39,10,29,71,158,99,1
3350,30,23,8,20,2,9,33,27.3,24,23,4,19,17,47,15,0
3351,30,22,12,13,5,11,40,27.5,29,26,1,25,20,50,11,0
3352,38,19,29,8,1,20,42,47.6,22,18,2,16,17,55,51,0
3353,72,53,38,25,9,42,68,61.8,26,40,13,27,41,113,68,0
3354,8,5,2,4,2,4,9,44.4,5,13,3,10,2,10,25,0
3355,54,23,30,19,5,29,40,72.5,11,40,11,29,26,80,70,2
3356,0,0,0,0,0,0,0,0.0,0,2,0,2,0,0,13,1
3357,23,16,7,14,2,13,21,61.9,8,19,7,12,19,42,29,2
3358,47,33,13,25,9,23,30,76.7,7,21,8,13,19,66,30,0
3359,40,20,23,12,5,12,24,50.0,12,20,5,15,18,58,19,0
3360,0,0,0,0,0,0,0,0.0,0,0,0,0,1,1,11,2
3361,10,10,5,3,2,2,17,11.8,15,9,0,9,3,13,7,0
3362,18,14,13,5,0,12,18,66.7,6,19,11,8,10,28,43,0
3363,24,11,9,7,8,11,31,35.5,20,18,0,18,9,33,2,0
3364,29,18,15,13,1,17,26,65.4,9,8,0,8,10,39,11,1
3365,14,9,6,8,0,6,18,33.3,12,8,0,8,9,23,5,1
3366,20,12,17,3,0,9,13,69.2,4,7,4,3,12,32,36,3
3367,5,5,1,2,2,0,3,0.0,3,11,1,10,1,6,7,0
3368,5,2,1,4,0,3,4,75.0,1,6,1,5,0,5,11,0
3369,5,3,3,2,0,3,6,50.0,3,4,0,4,4,9,0,0
3370,7,1,2,3,2,3,5,60.0,2,3,1,2,1,8,1,0
3371,3,3,0,3,0,3,4,75.0,1,4,0,4,5,8,0,0
3372,2,0,0,2,0,0,0,0.0,0,1,0,1,1,3,2,0
3373,0,0,0,0,0,0,1,0.0,1,2,1,1,3,3,1,0
3374,0,0,0,0,0,0,0,0.0,0,0,0,0,0,0,1,0
3375,0,0,0,0,0,0,0,0.0,0,0,0,0,0,0,0,0
3376,0,0,0,0,0,0,0,0.0,0,0,0,0,0,0,0,0
3377,2,1,1,1,0,1,1,100.0,0,0,0,0,0,2,1,0
3378,50,28,20,29,1,30,76,39.5,46,22,5,17,31,81,28,0
3379,0,0,0,0,0,0,2,0.0,2,0,0,0,0,0,14,0
3380,34,26,22,10,2,18,29,62.1,11,19,10,9,32,66,81,0
3381,18,11,8,6,4,10,31,32.3,21,18,5,13,13,31,17,0
3382,21,14,7,11,3,6,28,21.4,22,21,5,16,12,33,29,0
3383,42,28,28,13,1,28,38,73.7,10,35,18,17,36,78,78,1
3384,70,42,34,30,6,30,59,50.8,29,22,8,14,26,96,30,0
3385,27,16,13,8,6,12,25,48.0,13,8,2,6,12,39,31,0
3386,7,5,2,5,0,2,8,25.0,6,9,1,8,3,10,5,1
3387,43,26,29,10,4,28,60,46.7,32,19,1,18,21,64,38,0
3388,34,19,21,11,2,19,35,54.3,16,37,26,11,26,60,111,0
3389,37,19,16,17,4,18,44,40.9,26,17,5,12,18,55,34,0
3390,29,20,15,12,2,16,25,64.0,9,22,1,21,18,47,22,0
3391,9,4,4,3,2,3,8,37.5,5,3,0,3,3,12,5,0
3392,38,20,14,17,7,17,37,45.9,20,16,3,13,11,49,13,0
3393,11,6,9,2,0,7,14,50.0,7,12,3,9,12,23,47,1
3394,16,7,12,4,0,11,15,73.3,4,6,0,6,7,23,28,0
3395,35,23,23,10,2,17,24,70.8,7,7,0,7,14,49,32,0
3396,9,4,3,3,3,6,11,54.5,5,10,1,9,10,19,8,0
3397,15,9,12,2,1,5,7,71.4,2,13,4,9,8,23,25,0
3398,0,0,0,0,0,0,0,0.0,0,0,0,0,0,0,7,0
3399,8,4,2,5,1,3,7,42.9,4,3,0,3,1,9,1,0
3400,7,6,1,6,0,2,2,100.0,0,5,0,5,2,9,2,0
3401,0,0,0,0,0,0,1,0.0,1,1,0,1,1,1,1,0
3402,10,7,2,5,3,5,15,33.3,10,4,0,4,4,14,4,1
3403,3,2,2,0,1,1,4,25.0,3,7,2,5,6,9,1,0
3404,2,1,2,0,0,2,3,66.7,1,2,1,1,0,2,1,0
3405,0,0,0,0,0,0,0,0.0,0,0,0,0,0,0,1,0
3406,6,4,5,1,0,1,2,50.0,1,0,0,0,3,9,2,0
3407,0,0,0,0,0,0,3,0.0,3,0,0,0,1,1,1,0
3408,0,0,0,0,0,0,0,0.0,0,0,0,0,0,0,0,0
3409,0,0,0,0,0,0,0,0.0,0,0,0,0,0,0,1,0
3410,0,0,0,0,0,0,1,0.0,1,0,0,0,0,0,0,0
3411,1,1,1,0,0,1,2,50.0,1,1,1,0,1,2,0,0
3412,0,0,0,0,0,0,0,0.0,0,0,0,0,0,0,0,0
3413,0,0,0,0,0,0,2,0.0,2,0,0,0,0,0,13,1
3414,50,28,40,9,1,28,42,66.7,14,50,30,20,32,82,142,1
3415,53,33,27,23,3,24,40,60.0,16,35,18,17,66,119,93,2
3416,55,36,37,15,3,32,59,54.2,27,45,7,38,35,90,68,1
3417,47,28,22,22,3,30,60,50.0,30,30,8,22,25,72,33,0
3418,31,18,14,14,3,7,18,38.9,11,23,2,21,13,44,25,0
3419,34,19,11,13,10,15,43,34.9,28,18,5,13,22,56,18,1
3420,15,9,13,2,0,7,11,63.6,4,21,16,5,44,59,104,0
3421,46,24,24,19,3,31,73,42.5,42,20,3,17,23,69,16,1
3422,38,19,15,15,8,16,39,41.0,23,26,2,24,19,57,7,0
3423,22,10,13,6,3,13,20,65.0,7,21,15,6,21,43,57,0
3424,37,26,21,12,4,18,30,60.0,12,12,2,10,16,53,17,0
3425,13,5,2,5,6,2,10,20.0,8,8,1,7,2,15,11,0
3426,15,11,7,6,2,6,9,66.7,3,8,3,5,2,17,11,0
3427,23,11,16,7,0,15,25,60.0,10,9,3,6,20,43,14,2
3428,3,2,2,1,0,2,4,50.0,2,6,1,5,3,6,4,0
3429,20,12,7,7,6,11,21,52.4,10,11,2,9,7,27,5,0
3430,25,17,8,16,1,12,24,50.0,12,2,1,1,4,29,5,0
3431,16,12,5,9,2,8,18,44.4,10,4,0,4,3,19,3,1
3432,8,7,5,2,1,2,9,22.2,7,5,1,4,6,14,10,0
3433,2,0,2,0,0,0,4,0.0,4,0,0,0,0,2,2,0
3434,0,0,0,0,0,0,3,0.0,3,7,3,4,0,0,2,0
3435,2,1,1,1,0,1,4,25.0,3,0,0,0,0,2,3,0
3436,0,0,0,0,0,0,0,0.0,0,0,0,0,0,0,0,0
3437,2,1,0,1,1,1,2,50.0,1,0,0,0,0,2,0,0
3438,1,1,0,1,0,1,1,100.0,0,1,1,0,0,1,1,0
3439,2,2,1,1,0,1,1,100.0,0,0,0,0,0,2,0,0
3440,2,1,2,0,0,1,2,50.0,1,1,0,1,3,5,24,3
3441,55,37,38,12,5,38,56,67.9,18,62,16,46,50,105,108,0
3442,54,28,24,21,9,19,56,33.9,37,48,7,41,44,98,44,0
3443,62,42,26,30,6,24,49,49.0,25,35,2,33,28,90,34,0
3444,19,12,13,6,0,8,21,38.1,13,33,20,13,30,49,86,0
3445,39,23,25,7,7,16,29,55.2,13,22,7,15,20,59,71,0
3446,31,24,11,13,7,13,32,40.6,19,15,2,13,11,42,32,1
3447,40,19,31,9,0,20,35,57.1,15,41,28,13,20,60,107,1
3448,4,3,1,2,1,0,9,0.0,9,11,0,11,8,12,3,0
3449,32,15,24,7,1,13,23,56.5,10,16,9,7,18,50,68,2
3450,31,22,20,9,2,17,38,44.7,21,17,8,9,27,58,38,0
3451,40,20,23,12,5,16,40,40.0,24,19,2,17,10,50,14,0
3452,18,14,8,7,3,8,19,42.1,11,13,3,10,10,28,23,0
3453,8,5,2,3,3,3,5,60.0,2,4,0,4,8,16,3,0
3454,20,13,12,7,1,11,17,64.7,6,9,6,3,13,33,38,1
3455,13,9,7,6,0,3,10,30.0,7,7,1,6,6,19,9,0
3456,18,8,10,7,1,7,21,33.3,14,11,1,10,11,29,16,0
3457,19,12,16,2,1,6,7,85.7,1,14,9,5,8,27,64,0
3458,9,2,3,2,4,2,6,33.3,4,6,1,5,0,9,9,0
3459,11,4,6,3,2,1,9,11.1,8,11,3,8,11,22,15,1
3460,7,2,2,4,1,2,5,40.0,3,4,0,4,0,7,11,0
3461,5,4,0,3,2,1,2,50.0,1,2,0,2,0,5,0,0
3462,3,1,2,1,0,1,4,25.0,3,5,2,3,4,7,8,0
3463,0,0,0,0,0,0,2,0.0,2,1,0,1,1,1,2,0
3464,6,6,1,5,0,4,7,57.1,3,0,0,0,0,6,1,0
3465,5,1,0,1,4,1,2,50.0,1,1,0,1,1,6,2,0
3466,2,2,1,0,1,1,3,33.3,2,2,0,2,4,6,2,0
3467,3,1,0,3,0,0,3,0.0,3,3,0,3,1,4,0,0
3468,6,4,2,1,3,2,2,100.0,0,3,0,3,1,7,2,0
3469,0,0,0,0,0,0,0,0.0,0,0,0,0,0,0,0,0
3470,0,0,0,0,0,0,1,0.0,1,0,0,0,0,0,15,3
3471,85,52,43,34,8,38,96,39.6,58,29,6,23,61,146,61,3
3472,32,15,12,14,6,9,30,30.0,21,22,1,21,19,51,20,0
3473,38,22,23,13,2,19,32,59.4,13,39,23,16,32,70,114,0
3474,25,12,16,9,0,8,14,57.1,6,38,20,18,36,61,101,2
3475,23,14,15,7,1,16,36,44.4,20,36,26,10,11,34,116,1
3476,13,6,5,4,4,6,15,40.0,9,6,1,5,7,20,3,1
3477,35,22,25,7,3,19,40,47.5,21,24,3,21,12,47,42,0
3478,34,17,14,17,3,15,28,53.6,13,10,4,6,26,60,15,1
3479,13,9,8,3,2,6,7,85.7,1,15,8,7,18,31,64,1
3480,14,9,3,8,3,4,10,40.0,6,7,1,6,2,16,3,0
3481,33,19,24,8,1,20,33,60.6,13,23,12,11,20,53,59,1
3482,26,20,16,8,2,16,25,64.0,9,20,4,16,8,34,18,0
3483,18,14,9,9,0,12,19,63.2,7,19,2,17,6,24,9,1
3484,30,23,17,11,2,14,25,56.0,11,14,2,12,15,45,36,0
3485,7,4,2,2,3,1,9,11.1,8,6,0,6,10,17,5,0
3486,23,17,13,8,2,12,22,54.5,10,18,2,16,5,28,30,0
3487,6,4,2,3,1,3,9,33.3,6,4,1,3,2,8,8,0
3488,13,7,2,8,3,2,8,25.0,6,8,1,7,9,22,4,0
3489,5,0,4,0,1,4,8,50.0,4,11,3,8,3,8,10,0
3490,3,1,2,1,0,1,5,20.0,4,8,2,6,7,10,20,0
3491,3,3,0,3,0,1,3,33.3,2,3,0,3,0,3,7,0
3492,5,4,3,2,0,2,6,33.3,4,12,1,11,8,13,5,0
3493,8,6,0,4,4,3,3,100.0,0,4,0,4,1,9,6,0
3494,4,2,1,1,2,2,4,50.0,2,3,0,3,2,6,3,0
3495,6,4,2,2,2,2,9,22.2,7,2,1,1,4,10,2,0
3496,10,6,5,4,1,6,10,60.0,4,2,0,2,3,13,1,0
3497,8,6,6,1,1,4,6,66.7,2,0,0,0,3,11,6,0
3498,2,1,2,0,0,0,1,0.0,1,3,2,1,3,5,9,0
3499,4,1,4,0,0,1,1,100.0,0,1,0,1,0,4,3,0
3500,1,0,1,0,0,0,2,0.0,2,2,2,0,0,1,7,0
3501,5,2,2,2,1,3,5,60.0,2,1,1,0,1,6,0,0
3502,1,1,0,1,0,0,0,0.0,0,0,0,0,1,2,2,0
3503,0,0,0,0,0,0,1,0.0,1,0,0,0,0,0,0,0
3504,0,0,0,0,0,0,0,0.0,0,0,0,0,0,0,0,0
3505,5,0,3,1,1,3,7,42.9,4,1,0,1,0,5,1,0
3506,0,0,0,0,0,0,0,0.0,0,0,0,0,0,0,0,0
3507,0,0,0,0,0,0,1,0.0,1,0,0,0,0,0,0,0
3508,51,38,41,9,1,32,40,80.0,8,37,20,17,33,84,99,2
3509,1,1,1,0,0,1,2,50.0,1,0,0,0,1,2,13,5
3510,25,14,10,13,2,11,27,40.7,16,20,2,18,8,33,5,1
3511,48,24,25,18,5,28,63,44.4,35,28,6,22,57,105,84,0
3512,43,22,18,21,4,23,81,28.4,58,31,9,22,36,79,24,4
3513,30,18,11,14,5,14,35,40.0,21,20,3,17,13,43,30,0
3514,38,28,31,5,2,19,29,65.5,10,18,12,6,18,56,69,2
3515,49,31,12,32,5,22,47,46.8,25,38,13,25,19,68,26,1
3516,6,2,0,4,2,1,4,25.0,3,6,2,4,0,6,15,0
3517,47,33,14,27,6,25,57,43.9,32,18,3,15,20,67,11,0
3518,31,20,17,11,3,17,34,50.0,17,14,3,11,16,47,34,0
3519,30,18,4,17,9,11,24,45.8,13,17,3,14,12,42,15,0
3520,18,11,11,7,0,10,18,55.6,8,14,10,4,13,31,74,1
3521,32,24,17,15,0,24,31,77.4,7,15,7,8,25,57,37,0
3522,34,19,14,15,5,17,28,60.7,11,27,10,17,29,63,30,0
3523,26,15,17,9,0,20,36,55.6,16,16,2,14,13,39,21,0
3524,9,5,4,4,1,4,11,36.4,7,7,0,7,3,12,7,0
3525,6,4,2,2,2,2,3,66.7,1,5,1,4,1,7,10,0
3526,22,12,6,10,6,10,23,43.5,13,9,0,9,8,30,3,0
3527,19,9,13,6,0,11,18,61.1,7,25,19,6,9,28,35,3
3528,0,0,0,0,0,0,0,0.0,0,0,0,0,0,0,2,0
3529,4,3,4,0,0,3,3,100.0,0,7,3,4,6,10,10,0
3530,3,3,2,0,1,2,3,66.7,1,1,0,1,1,4,3,0
3531,4,1,3,1,0,3,5,60.0,2,4,2,2,5,9,8,0
3532,1,1,0,1,0,1,3,33.3,2,1,0,1,0,1,1,0
3533,2,1,0,1,1,0,4,0.0,4,2,0,2,0,2,1,0
3534,0,0,0,0,0,0,1,0.0,1,1,0,1,1,1,0,0
3535,1,1,1,0,0,1,3,33.3,2,0,0,0,0,1,0,0
3536,1,0,1,0,0,0,0,0.0,0,0,0,0,0,1,0,0
3537,0,0,0,0,0,0,0,0.0,0,0,0,0,0,0,0,0
3538,0,0,0,0,0,0,0,0.0,0,1,0,1,0,0,0,0
3539,70,43,25,33,12,29,60,48.3,31,32,8,24,26,96,41,4
3540,31,20,11,10,10,13,31,41.9,18,30,0,30,13,44,18,1
3541,0,0,0,0,0,0,1,0.0,1,0,0,0,0,0,10,1
3542,24,13,5,8,11,8,32,25.0,24,30,0,30,2,26,14,1
3543,38,24,19,17,2,19,39,48.7,20,19,6,13,27,65,40,1
3544,51,23,13,25,13,25,57,43.9,32,32,4,28,17,68,15,1
3545,6,3,0,3,3,2,3,66.7,1,11,1,10,2,8,16,0
3546,39,20,14,21,4,19,26,73.1,7,32,17,15,30,69,77,0
3547,42,28,16,18,8,22,39,56.4,17,28,12,16,23,65,70,3
3548,55,33,21,24,10,21,38,55.3,17,36,12,24,27,82,37,3
3549,26,16,15,8,3,13,20,65.0,7,17,2,15,14,40,54,0
3550,39,22,13,12,14,9,20,45.0,11,14,0,14,9,48,5,0
3551,36,25,16,15,5,18,28,64.3,10,23,1,22,10,46,10,0
3552,14,9,1,5,8,7,20,35.0,13,5,0,5,4,18,4,0
3553,2,1,1,0,1,0,3,0.0,3,11,7,4,10,12,21,0
3554,13,8,6,7,0,6,12,50.0,6,13,2,11,6,19,5,0
3555,10,7,4,4,2,3,7,42.9,4,7,1,6,4,14,6,0
3556,10,4,1,7,2,5,16,31.3,11,7,1,6,1,11,8,1
3557,0,0,0,0,0,0,0,0.0,0,0,0,0,0,0,2,1
3558,7,3,1,2,4,2,4,50.0,2,4,0,4,5,12,1,0
3559,3,3,1,1,1,0,0,0.0,0,0,0,0,2,5,2,0
3560,1,0,0,1,0,1,2,50.0,1,0,0,0,1,2,0,0
3561,0,0,0,0,0,0,0,0.0,0,1,1,0,0,0,1,0
3562,0,0,0,0,0,0,0,0.0,0,0,0,0,0,0,0,0
3563,0,0,0,0,0,0,0,0.0,0,1,0,1,0,0,0,0
3564,41,26,28,12,1,20,27,74.1,7,32,17,15,29,70,81,3
3565,83,51,37,38,8,32,57,56.1,25,37,11,26,44,127,52,0
3566,49,17,18,21,10,17,58,29.3,41,23,1,22,15,64,5,0
3567,48,28,20,22,6,26,58,44.8,32,48,22,26,32,80,77,1
3568,66,35,22,24,20,26,59,44.1,33,43,2,41,15,81,24,1
3569,48,28,24,22,2,17,22,77.3,5,44,33,11,31,79,100,1
3570,1,1,1,0,0,1,1,100.0,0,0,0,0,0,1,8,5
3571,35,15,7,21,7,14,39,35.9,25,26,1,25,20,55,22,0
3572,30,24,9,12,9,13,32,40.6,19,23,1,22,5,35,9,1
3573,50,30,19,24,7,35,52,67.3,17,18,3,15,20,70,26,2
3574,27,16,8,9,10,9,25,36.0,16,27,1,26,8,35,6,0
3575,24,17,11,5,8,5,18,27.8,13,23,1,22,13,37,12,0
3576,20,12,11,8,1,14,19,73.7,5,11,3,8,8,28,28,1
3577,20,9,15,4,1,11,18,61.1,7,10,4,6,18,38,33,0
3578,12,7,2,6,4,2,7,28.6,5,11,0,11,4,16,4,0
3579,24,10,6,10,8,11,23,47.8,12,17,1,16,12,36,7,1
3580,14,11,9,4,1,5,10,50.0,5,9,3,6,11,25,9,0
3581,0,0,0,0,0,0,0,0.0,0,0,0,0,0,0,3,2
3582,4,1,2,2,0,2,4,50.0,2,3,1,2,3,7,1,0
3583,3,2,2,0,1,3,3,100.0,0,0,0,0,2,5,2,0
3584,9,6,5,1,3,8,10,80.0,2,5,1,4,1,10,5,0
3585,2,2,1,1,0,0,0,0.0,0,1,0,1,0,2,1,0
3586,0,0,0,0,0,0,0,0.0,0,0,0,0,0,0,0,0
3587,0,0,0,0,0,0,1,0.0,1,0,0,0,1,1,0,0
3588,0,0,0,0,0,0,0,0.0,0,1,0,1,0,0,0,0
3589,40,23,24,13,3,12,14,85.7,2,47,34,13,39,79,144,0
3590,35,25,5,17,13,7,30,23.3,23,15,0,15,3,38,8,0
3591,99,55,35,50,14,59,125,47.2,66,65,8,57,35,134,25,1
3592,17,11,1,8,8,6,21,28.6,15,19,1,18,2,19,1,0
3593,0,0,0,0,0,0,1,0.0,1,0,0,0,0,0,11,4
3594,39,26,26,11,2,27,87,31.0,60,22,2,20,31,70,48,5
3595,32,19,12,12,8,16,50,32.0,34,37,2,35,15,47,16,1
3596,22,12,2,10,10,11,23,47.8,12,18,6,12,3,25,9,0
3597,48,28,11,31,6,20,61,32.8,41,24,2,22,20,68,31,3
3598,35,24,21,11,3,26,43,60.5,17,20,6,14,13,48,40,0
3599,47,31,24,16,7,30,63,47.6,33,26,4,22,19,66,50,2
3600,27,17,8,14,5,8,25,32.0,17,21,4,17,14,41,7,0
3601,36,22,22,13,1,18,24,75.0,6,18,12,6,20,56,51,1
3602,27,14,12,12,3,10,23,43.5,13,22,0,22,7,34,8,0
3603,23,13,6,13,4,10,23,43.5,13,9,1,8,7,30,4,0
3604,25,22,17,7,1,14,20,70.0,6,16,8,8,17,42,39,1
3605,26,12,5,13,8,12,29,41.4,17,20,2,18,14,40,11,0
3606,27,17,8,14,5,10,31,32.3,21,27,0,27,6,33,7,0
3607,0,0,0,0,0,0,0,0.0,0,0,0,0,0,0,4,1
3608,33,25,14,12,7,24,38,63.2,14,17,1,16,10,43,14,0
3609,12,6,7,4,1,8,12,66.7,4,16,12,4,9,21,43,0
3610,19,13,9,6,4,9,15,60.0,6,9,1,8,6,25,10,0
3611,2,1,1,1,0,1,5,20.0,4,6,2,4,1,3,1,0
3612,4,1,3,1,0,3,5,60.0,2,0,0,0,0,4,0,0
3613,0,0,0,0,0,0,0,0.0,0,0,0,0,0,0,0,0
3614,0,0,0,0,0,0,0,0.0,0,0,0,0,0,0,0,0
3615,2,1,1,1,0,0,0,0.0,0,0,0,0,0,2,1,0
3616,0,0,0,0,0,0,0,0.0,0,0,0,0,0,0,0,0
3617,0,0,0,0,0,0,0,0.0,0,1,0,1,1,1,0,0
3618,0,0,0,0,0,0,0,0.0,0,0,0,0,0,0,0,0
3619,12,7,0,5,7,5,11,45.5,6,26,4,22,4,16,20,0
3620,54,32,28,23,3,23,27,85.2,4,36,20,16,28,82,73,3
3621,59,35,18,34,7,32,77,41.6,45,33,4,29,21,80,21,0
3622,58,38,21,27,10,25,53,47.2,28,32,8,24,23,81,18,2
3623,0,0,0,0,0,0,0,0.0,0,0,0,0,0,0,12,3
3624,29,18,17,11,1,14,30,46.7,16,28,12,16,14,43,75,0
3625,47,19,35,9,3,25,44,56.8,19,20,2,18,26,73,67,0
3626,12,5,5,4,3,4,22,18.2,18,8,1,7,9,21,6,0
3627,54,31,24,24,6,29,59,49.2,30,35,14,21,18,72,59,0
3628,13,7,7,4,2,5,20,25.0,15,18,1,17,9,22,6,0
3629,27,16,22,4,1,13,21,61.9,8,24,19,5,13,40,78,3
3630,43,29,16,21,6,24,47,51.1,23,21,7,14,21,64,16,0
3631,41,20,17,18,6,16,40,40.0,24,23,3,20,15,56,9,0
3632,13,9,7,5,1,7,13,53.8,6,19,11,8,7,20,47,1
3633,18,12,18,0,0,12,19,63.2,7,11,2,9,13,31,37,0
3634,19,9,10,7,2,9,17,52.9,8,13,0,13,1,20,11,0
3635,16,8,7,6,3,5,15,33.3,10,15,2,13,3,19,8,0
3636,8,1,3,2,3,2,11,18.2,9,11,0,11,3,11,11,0
3637,0,0,0,0,0,0,0,0.0,0,0,0,0,0,0,1,0
3638,6,5,3,1,2,1,6,16.7,5,6,0,6,1,7,10,0
3639,7,5,4,2,1,4,9,44.4,5,3,0,3,2,9,3,0
3640,3,0,3,0,0,0,1,0.0,1,2,1,1,2,5,4,0
3641,6,4,3,2,1,4,5,80.0,1,5,2,3,2,8,3,1
3642,0,0,0,0,0,0,0,0.0,0,0,0,0,1,1,1,0
3643,1,0,0,1,0,1,2,50.0,1,0,0,0,0,1,0,0
3644,0,0,0,0,0,0,1,0.0,1,0,0,0,0,0,0,0
3645,1,1,1,0,0,0,0,0.0,0,0,0,0,0,1,1,0
3646,0,0,0,0,0,0,0,0.0,0,0,0,0,0,0,0,0
3647,0,0,0,0,0,0,0,0.0,0,0,0,0,0,0,0,0
3648,0,0,0,0,0,0,0,0.0,0,0,0,0,0,0,0,0
3649,0,0,0,0,0,0,0,0.0,0,0,0,0,0,0,0,0
3650,0,0,0,0,0,0,1,0.0,1,0,0,0,1,1,31,2
3651,91,63,43,34,14,62,120,51.7,58,63,18,45,34,125,102,3
3652,21,13,6,7,8,10,21,47.6,11,4,1,3,8,29,4,0
3653,66,40,35,25,6,32,44,72.7,12,46,22,24,44,110,106,1
3654,62,33,19,20,23,25,67,37.3,42,24,1,23,18,80,2,1
3655,68,33,41,16,11,27,49,55.1,22,27,8,19,37,105,80,5
3656,49,35,34,12,3,24,33,72.7,9,25,15,10,18,67,78,1
3657,34,24,11,17,6,15,36,41.7,21,21,5,16,31,65,28,1
3658,33,19,5,18,10,15,29,51.7,14,15,3,12,13,46,10,1
3659,80,52,32,36,12,41,61,67.2,20,28,5,23,37,117,43,3
3660,26,15,14,5,7,12,31,38.7,19,37,1,36,10,36,12,1
3661,16,11,4,8,4,2,10,20.0,8,32,6,26,8,24,23,0
3662,23,15,10,11,2,10,24,41.7,14,15,4,11,17,40,16,1
3663,24,17,13,8,3,16,21,76.2,5,17,15,2,10,34,35,0
3664,36,24,23,10,3,21,43,48.8,22,23,10,13,20,56,50,1
3665,7,4,3,4,0,5,18,27.8,13,12,0,12,3,10,2,0
3666,32,18,13,17,2,13,34,38.2,21,21,7,14,19,51,30,3
3667,18,12,9,6,3,11,18,61.1,7,12,1,11,3,21,9,0
3668,22,13,10,8,4,9,14,64.3,5,4,1,3,5,27,2,0
3669,5,3,5,0,0,3,3,100.0,0,5,4,1,8,13,19,0
3670,1,0,0,0,1,1,4,25.0,3,3,0,3,3,4,4,0
3671,2,1,2,0,0,2,2,100.0,0,3,3,0,2,4,12,0
3672,3,2,1,1,1,3,5,60.0,2,1,0,1,2,5,1,0
3673,0,0,0,0,0,0,0,0.0,0,3,2,1,1,1,2,0
3674,1,0,1,0,0,0,0,0.0,0,0,0,0,0,1,0,0
3675,1,1,0,0,1,0,1,0.0,1,0,0,0,0,1,0,0
3676,0,0,0,0,0,0,0,0.0,0,0,0,0,0,0,1,0
3677,0,0,0,0,0,0,0,0.0,0,0,0,0,0,0,3,0
3678,85,52,37,31,17,33,77,42.9,44,50,11,39,43,128,34,0
3679,91,46,38,42,11,36,60,60.0,24,59,25,34,37,128,44,4
3680,21,13,5,8,8,5,24,20.8,19,20,5,15,4,25,17,0
3681,23,12,9,6,8,8,19,42.1,11,20,2,18,20,43,13,2
3682,33,19,20,10,3,23,30,76.7,7,26,19,7,18,51,102,2
3683,29,15,22,6,1,20,34,58.8,14,33,24,9,26,55,153,4
3684,50,22,22,18,10,27,65,41.5,38,36,13,23,17,67,28,0
3685,0,0,0,0,0,0,0,0.0,0,0,0,0,0,0,12,3
3686,21,10,7,8,6,12,26,46.2,14,13,0,13,13,34,9,1
3687,48,30,26,17,5,26,34,76.5,8,28,10,18,26,74,66,0
3688,62,38,36,21,5,34,64,53.1,30,36,13,23,22,84,48,0
3689,55,27,34,15,6,35,52,67.3,17,28,4,24,17,72,43,1
3690,21,12,9,7,5,10,32,31.3,22,14,1,13,9,30,9,0
3691,0,0,0,0,0,0,0,0.0,0,0,0,0,0,0,11,3
3692,21,15,12,9,0,9,14,64.3,5,21,14,7,18,39,66,2
3693,16,10,8,4,4,11,34,32.4,23,11,0,11,4,20,14,0
3694,16,12,10,2,4,10,15,66.7,5,8,7,1,8,24,51,0
3695,15,10,5,9,1,5,8,62.5,3,11,3,8,4,19,19,1
3696,3,0,0,1,2,1,2,50.0,1,5,1,4,0,3,3,0
3697,14,9,10,3,1,8,10,80.0,2,4,4,0,3,17,7,1
3698,14,10,4,8,2,4,10,40.0,6,6,2,4,1,15,5,0
3699,5,4,0,4,1,1,2,50.0,1,4,1,3,2,7,4,0
3700,6,4,3,3,0,1,3,33.3,2,1,1,0,0,6,1,0
3701,4,0,4,0,0,2,5,40.0,3,6,3,3,3,7,11,0
3702,3,2,1,1,1,0,4,0.0,4,4,0,4,3,6,10,0
3703,5,3,2,1,2,2,5,40.0,3,1,0,1,0,5,4,0
3704,1,0,0,1,0,0,0,0.0,0,0,0,0,0,1,1,0
3705,1,1,1,0,0,0,1,0.0,1,0,0,0,0,1,0,0
3706,0,0,0,0,0,0,0,0.0,0,0,0,0,0,0,0,0
3707,0,0,0,0,0,0,0,0.0,0,3,3,0,0,0,0,0
3708,0,0,0,0,0,0,0,0.0,0,0,0,0,0,0,0,0
3709,0,0,0,0,0,0,0,0.0,0,0,0,0,0,0,0,0
3710,88,53,45,32,11,40,77,51.9,37,52,14,38,34,122,20,0
3711,42,24,27,13,2,18,40,45.0,22,50,38,12,36,78,131,1
3712,55,34,16,28,11,22,64,34.4,42,27,0,27,7,62,7,0
3713,61,33,37,20,4,26,61,42.6,35,55,25,30,37,98,124,1
3714,54,30,17,29,8,24,63,38.1,39,43,7,36,17,71,23,0
3715,5,0,2,1,2,2,8,25.0,6,16,1,15,6,11,13,0
3716,57,27,30,16,11,37,77,48.1,40,41,8,33,24,81,56,3
3717,36,24,13,15,8,11,29,37.9,18,29,2,27,10,46,13,0
3718,0,0,0,0,0,0,4,0.0,4,0,0,0,0,0,8,1
3719,20,13,14,6,0,8,13,61.5,5,20,16,4,9,29,61,3
3720,0,0,0,0,0,0,1,0.0,1,0,0,0,0,0,7,2
3721,39,27,21,15,3,14,38,36.8,24,23,7,16,19,58,11,1
3722,33,21,6,20,7,15,32,46.9,17,20,3,17,8,41,18,2
3723,20,10,8,4,8,12,26,46.2,14,18,0,18,5,25,16,0
3724,14,9,7,7,0,6,11,54.5,5,17,12,5,5,19,42,0
3725,23,13,15,6,2,10,21,47.6,11,16,7,9,25,48,41,1
3726,24,18,12,9,3,15,29,51.7,14,23,4,19,8,32,23,0
3727,5,3,0,2,3,0,4,0.0,4,6,0,6,2,7,4,0
3728,21,14,10,7,4,12,25,48.0,13,8,3,5,9,30,21,0
3729,28,18,17,10,1,17,28,60.7,11,17,2,15,13,41,21,1
3730,6,1,3,2,1,1,2,50.0,1,1,0,1,5,11,3,0
3731,7,7,4,2,1,3,9,33.3,6,3,0,3,2,9,4,0
3732,13,7,7,6,0,4,11,36.4,7,7,0,7,1,14,1,0
3733,0,0,0,0,0,0,0,0.0,0,0,0,0,0,0,1,0
3734,2,0,1,1,0,1,1,100.0,0,1,0,1,0,2,2,0
3735,5,3,2,2,1,2,4,50.0,2,3,2,1,1,6,5,0
3736,0,0,0,0,0,0,0,0.0,0,1,0,1,0,0,1,0
3737,1,0,1,0,0,1,1,100.0,0,0,0,0,0,1,1,0
3738,1,1,0,1,0,1,2,50.0,1,1,0,1,1,2,0,0
3739,1,1,1,0,0,0,0,0.0,0,0,0,0,0,1,0,0
3740,0,0,0,0,0,0,0,0.0,0,0,0,0,0,0,0,0
3741,0,0,0,0,0,0,0,0.0,0,0,0,0,0,0,0,0
3742,2,0,2,0,0,2,2,100.0,0,0,0,0,0,2,11,2
3743,81,51,58,12,11,51,74,68.9,23,44,16,28,37,118,109,0
3744,68,38,27,25,16,30,88,34.1,58,49,6,43,27,95,49,2
3745,22,15,7,6,9,12,45,26.7,33,26,2,24,18,40,18,0
3746,19,12,9,4,6,9,26,34.6,17,15,1,14,4,23,20,0
3747,11,7,2,3,6,5,13,38.5,8,9,1,8,1,12,19,0
3748,83,56,43,32,8,51,106,48.1,55,74,33,41,17,100,71,1
3749,47,27,20,16,11,21,45,46.7,24,20,12,8,22,69,30,1
3750,42,25,18,20,4,19,26,73.1,7,30,15,15,41,83,68,1
3751,48,24,23,23,2,22,33,66.7,11,34,12,22,14,62,53,0
3752,24,17,14,10,0,12,22,54.5,10,33,24,9,25,49,83,1
3753,18,11,10,7,1,10,14,71.4,4,23,18,5,15,33,88,0
3754,22,14,20,2,0,12,21,57.1,9,25,18,7,23,45,75,0
3755,40,21,15,19,6,20,40,50.0,20,29,1,28,12,52,9,0
3756,15,10,8,7,0,5,13,38.5,8,18,9,9,12,27,40,1
3757,18,13,5,10,3,12,33,36.4,21,17,6,11,4,22,13,0
3758,11,8,7,3,1,9,15,60.0,6,18,11,7,6,17,39,0
3759,27,16,17,8,2,17,31,54.8,14,19,7,12,8,35,19,2
3760,12,8,8,4,0,5,12,41.7,7,10,8,2,5,17,26,0
3761,22,14,6,10,6,6,16,37.5,10,6,1,5,6,28,3,0
3762,4,1,1,1,2,1,1,100.0,0,4,0,4,0,4,3,0
3763,13,8,6,2,5,8,17,47.1,9,10,0,10,5,18,7,0
3764,10,3,1,6,3,3,4,75.0,1,3,1,2,1,11,6,0
3765,3,1,1,2,0,1,3,33.3,2,6,3,3,4,7,14,1
3766,5,3,4,1,0,1,3,33.3,2,7,1,6,1,6,5,0
3767,3,3,1,2,0,1,3,33.3,2,1,1,0,0,3,0,0
3768,2,0,0,2,0,1,1,100.0,0,0,0,0,0,2,0,0
3769,1,0,1,0,0,1,3,33.3,2,1,0,1,1,2,0,0
3770,1,1,0,1,0,1,1,100.0,0,2,0,2,2,3,0,0
3771,0,0,0,0,0,0,0,0.0,0,1,0,1,0,0,0,0
3772,1,1,0,1,0,1,1,100.0,0,0,0,0,1,2,0,0
3773,64,41,50,12,2,38,75,50.7,37,49,15,34,43,107,97,0
3774,106,68,48,42,16,57,90,63.3,33,47,15,32,43,149,96,0
3775,42,28,14,14,14,13,35,37.1,22,37,5,32,19,61,14,0
3776,45,29,14,23,8,18,44,40.9,26,31,9,22,38,83,49,0
3777,53,35,24,26,3,21,47,44.7,26,55,28,27,37,90,109,0
3778,23,17,14,9,0,10,16,62.5,6,38,28,10,29,52,160,0
3779,1,1,1,0,0,1,3,33.3,2,0,0,0,1,2,16,0
3780,71,48,38,26,7,25,52,48.1,27,28,1,27,21,92,28,2
3781,80,39,47,26,7,31,66,47.0,35,59,20,39,42,122,81,0
3782,65,47,27,27,11,20,40,50.0,20,25,0,25,11,76,9,1
3783,26,14,19,7,0,16,22,72.7,6,33,24,9,17,43,85,2
3784,15,8,5,6,4,3,11,27.3,8,16,3,13,4,19,4,0
3785,28,16,17,9,2,17,21,81.0,4,21,13,8,23,51,79,3
3786,1,0,1,0,0,1,2,50.0,1,0,0,0,1,2,4,0
3787,11,5,9,2,0,6,7,85.7,1,13,10,3,3,14,29,0
3788,8,4,5,3,0,4,15,26.7,11,8,0,8,5,13,7,0
3789,11,7,7,3,1,9,14,64.3,5,2,1,1,5,16,14,0
3790,3,2,1,1,1,2,3,66.7,1,5,3,2,3,6,7,0
3791,10,6,4,3,3,5,16,31.3,11,8,1,7,6,16,7,0
3792,6,2,0,6,0,4,13,30.8,9,4,1,3,3,9,7,0
3793,11,6,2,8,1,5,9,55.6,4,4,1,3,4,15,2,1
3794,3,2,3,0,0,1,5,20.0,4,2,0,2,2,5,1,0
3795,0,0,0,0,0,0,0,0.0,0,0,0,0,0,0,0,0
3796,0,0,0,0,0,0,1,0.0,1,0,0,0,1,1,0,0
3797,1,1,0,1,0,0,0,0.0,0,2,2,0,0,1,0,0
3798,0,0,0,0,0,0,0,0.0,0,0,0,0,0,0,1,0
3799,56,35,33,21,2,29,39,74.4,10,33,18,15,41,97,207,1
3800,105,60,75,21,9,43,60,71.7,17,63,10,53,26,131,104,0
3801,65,36,23,28,14,21,42,50.0,21,43,2,41,16,81,15,0
3802,42,25,15,23,4,19,40,47.5,21,31,12,19,36,78,72,0
3803,22,15,4,11,7,6,10,60.0,4,13,4,9,4,26,14,0
3804,35,17,4,18,13,15,31,48.4,16,27,2,25,11,46,6,0
3805,46,28,21,22,3,20,30,66.7,10,32,12,20,27,73,109,0
3806,28,19,21,7,0,14,24,58.3,10,22,17,5,18,46,89,1
3807,45,28,26,18,1,30,47,63.8,17,17,10,7,14,59,94,1
3808,61,33,30,20,11,24,48,50.0,24,36,14,22,21,82,25,0
3809,1,0,1,0,0,1,1,100.0,0,0,0,0,1,2,5,0
3810,1,1,1,0,0,1,2,50.0,1,0,0,0,0,1,8,2
3811,24,12,8,8,8,4,19,21.1,15,17,1,16,6,30,19,0
3812,38,24,14,16,8,9,18,50.0,9,13,2,11,8,46,24,0
3813,55,35,31,14,10,19,38,50.0,19,29,7,22,24,79,47,0
3814,48,32,18,22,8,23,46,50.0,23,17,3,14,20,68,24,1
3815,24,15,11,11,2,14,21,66.7,7,18,6,12,10,34,33,0
3816,19,10,7,10,2,8,24,33.3,16,21,0,21,11,30,9,0
3817,34,17,15,13,6,18,30,60.0,12,13,2,11,20,54,12,0
3818,9,3,2,4,3,3,6,50.0,3,0,0,0,2,11,2,0
3819,3,3,2,1,0,1,7,14.3,6,4,0,4,1,4,1,0
3820,13,9,5,6,2,8,17,47.1,9,3,0,3,2,15,4,0
3821,10,6,3,6,1,5,6,83.3,1,2,0,2,0,10,2,0
3822,4,1,3,1,0,2,3,66.7,1,2,0,2,3,7,1,0
3823,0,0,0,0,0,0,0,0.0,0,0,0,0,1,1,0,0
3824,0,0,0,0,0,0,0,0.0,0,0,0,0,0,0,1,0
3825,70,46,33,21,16,31,72,43.1,41,41,8,33,22,92,32,3
3826,27,14,17,9,1,13,36,36.1,23,49,37,12,31,58,90,1
3827,47,26,25,19,3,27,45,60.0,18,49,27,22,30,77,76,4
3828,45,20,23,11,11,19,42,45.2,23,31,1,30,19,64,22,0
3829,26,16,14,10,2,11,35,31.4,24,23,9,14,11,37,14,1
3830,1,1,1,0,0,1,2,50.0,1,0,0,0,0,1,11,3
3831,35,17,9,17,9,10,17,58.8,7,12,0,12,9,44,17,1
3832,31,14,10,13,8,14,24,58.3,10,15,2,13,11,42,28,0
3833,25,18,7,16,2,17,29,58.6,12,22,9,13,14,39,52,1
3834,54,41,32,17,5,39,58,67.2,19,17,7,10,18,72,57,1
3835,0,0,0,0,0,0,3,0.0,3,0,0,0,0,0,8,1
3836,42,22,13,22,7,14,44,31.8,30,22,3,19,8,50,5,0
3837,13,6,3,7,3,5,19,26.3,14,15,1,14,5,18,12,0
3838,14,6,4,7,3,5,14,35.7,9,10,3,7,2,16,8,0
3839,40,20,17,19,4,23,46,50.0,23,35,7,28,18,58,30,3
3840,26,13,12,11,3,14,30,46.7,16,14,4,10,21,47,20,0
3841,14,12,8,5,1,6,18,33.3,12,16,12,4,16,30,43,1
3842,8,3,4,4,0,0,4,0.0,4,2,1,1,3,11,1,0
3843,20,14,9,10,1,9,14,64.3,5,9,0,9,8,28,16,0
3844,21,14,14,5,2,13,22,59.1,9,7,3,4,6,27,6,0
3845,14,5,7,4,3,5,13,38.5,8,6,2,4,14,28,18,0
3846,19,14,9,7,3,8,14,57.1,6,5,0,5,11,30,8,0
3847,19,10,9,5,5,9,18,50.0,9,8,2,6,2,21,12,0
3848,9,4,2,4,3,3,9,33.3,6,4,1,3,1,10,5,0
3849,6,2,3,2,1,2,7,28.6,5,11,0,11,0,6,3,0
3850,5,3,1,2,2,1,11,9.1,10,8,0,8,3,8,3,0
3851,11,5,4,5,2,6,8,75.0,2,3,0,3,4,15,3,1
3852,1,0,1,0,0,1,1,100.0,0,0,0,0,1,2,0,0
3853,1,0,1,0,0,1,2,50.0,1,2,1,1,0,1,1,0
3854,0,0,0,0,0,0,1,0.0,1,1,0,1,0,0,2,0
3855,59,32,29,29,1,23,50,46.0,27,53,34,19,33,92,143,4
3856,23,11,3,13,7,10,29,34.5,19,24,5,19,7,30,43,0
3857,86,44,34,35,17,39,92,42.4,53,52,11,41,52,138,53,1
3858,0,0,0,0,0,0,0,0.0,0,1,0,1,1,1,12,3
3859,61,41,24,30,7,34,63,54.0,29,32,11,21,65,126,46,1
3860,55,32,28,23,4,24,56,42.9,32,50,23,27,35,90,109,1
3861,28,14,5,12,11,8,30,26.7,22,16,1,15,8,36,11,0
3862,37,23,18,11,8,19,39,48.7,20,28,11,17,21,58,62,0
3863,53,34,25,22,6,26,48,54.2,22,31,3,28,5,58,23,0
3864,24,17,7,9,8,9,27,33.3,18,39,2,37,6,30,21,0
3865,47,26,31,13,3,30,42,71.4,12,31,11,20,20,67,60,2
3866,24,19,10,9,5,14,25,56.0,11,22,12,10,13,37,67,0
3867,33,16,7,22,4,9,27,33.3,18,31,5,26,20,53,28,1
3868,29,19,20,7,2,20,34,58.8,14,9,5,4,8,37,27,0
3869,45,27,22,11,12,19,34,55.9,15,18,3,15,22,67,35,0
3870,24,15,8,10,6,12,28,42.9,16,14,4,10,12,36,18,2
3871,23,12,9,10,4,9,16,56.3,7,18,0,18,8,31,4,0
3872,12,11,9,3,0,9,14,64.3,5,13,6,7,7,19,30,1
3873,0,0,0,0,0,0,0,0.0,0,0,0,0,0,0,2,0
3874,7,2,4,2,1,2,8,25.0,6,4,2,2,3,10,2,0
3875,6,4,2,3,1,2,5,40.0,3,4,2,2,1,7,6,0
3876,5,4,2,1,2,2,4,50.0,2,3,0,3,2,7,2,0
3877,0,0,0,0,0,0,0,0.0,0,0,0,0,0,0,0,0
3878,3,1,1,0,2,1,7,14.3,6,3,0,3,1,4,3,0
3879,4,3,1,3,0,2,3,66.7,1,2,0,2,4,8,2,0
3880,3,2,1,2,0,1,1,100.0,0,3,2,1,3,6,8,0
3881,0,0,0,0,0,0,0,0.0,0,0,0,0,0,0,0,0
3882,1,0,1,0,0,1,3,33.3,2,3,0,3,0,1,0,0
3883,1,1,0,1,0,0,3,0.0,3,0,0,0,0,1,0,0
3884,0,0,0,0,0,0,0,0.0,0,0,0,0,0,0,0,0
3885,0,0,0,0,0,0,0,0.0,0,0,0,0,0,0,14,1
3886,93,58,60,26,7,52,110,47.3,58,56,8,48,80,173,117,3
3887,25,12,4,12,9,11,41,26.8,30,16,2,14,4,29,12,0
3888,152,75,80,60,12,103,152,67.8,49,57,9,48,46,198,58,0
3889,49,24,23,16,10,26,44,59.1,18,38,10,28,38,87,69,1
3890,49,29,33,15,1,21,29,72.4,8,32,11,21,28,77,84,4
3891,29,18,12,15,2,12,25,48.0,13,16,0,16,14,43,9,0
3892,18,11,6,7,5,3,21,14.3,18,13,0,13,9,27,12,1
3893,21,11,16,5,0,12,21,57.1,9,16,11,5,25,46,80,0
3894,7,3,1,5,1,1,6,16.7,5,9,3,6,6,13,20,0
3895,18,12,4,8,6,7,20,35.0,13,11,3,8,4,22,13,0
3896,20,9,13,5,2,9,18,50.0,9,23,15,8,25,45,61,2
3897,22,14,5,15,2,4,16,25.0,12,24,2,22,5,27,14,0
3898,21,14,9,8,4,11,28,39.3,17,27,3,24,10,31,12,0
3899,30,16,23,5,2,15,20,75.0,5,28,19,9,17,47,80,1
3900,29,18,9,17,3,13,31,41.9,18,19,9,10,11,40,24,0
3901,24,16,10,12,2,13,25,52.0,12,16,4,12,13,37,6,0
3902,33,19,9,17,7,18,39,46.2,21,18,5,13,16,49,19,1
3903,27,17,19,6,2,11,19,57.9,8,10,3,7,16,43,35,0
3904,3,2,0,1,2,0,4,0.0,4,4,0,4,0,3,1,0
3905,4,3,1,2,1,3,6,50.0,3,2,0,2,1,5,2,0
3906,0,0,0,0,0,0,0,0.0,0,1,0,1,0,0,0,0
3907,1,1,1,0,0,0,1,0.0,1,0,0,0,0,1,0,0
3908,4,2,1,3,0,1,2,50.0,1,1,0,1,3,7,2,0
3909,0,0,0,0,0,0,0,0.0,0,0,0,0,0,0,0,0
3910,47,21,40,6,1,24,32,75.0,8,64,37,27,39,86,182,4
3911,79,48,52,19,8,38,64,59.4,26,44,8,36,36,115,85,1
3912,0,0,0,0,0,0,1,0.0,1,3,0,3,0,0,21,5
3913,90,58,46,33,11,25,47,53.2,22,36,9,27,41,131,64,0
3914,128,74,67,49,12,44,99,44.4,55,51,8,43,18,146,29,2
3915,44,25,32,8,4,24,37,64.9,13,40,19,21,26,70,93,2
3916,30,16,8,17,5,13,35,37.1,22,28,7,21,13,43,21,1
3917,71,44,41,23,7,28,49,57.1,21,32,6,26,15,86,38,0
3918,30,20,23,6,1,22,34,64.7,12,51,39,12,16,46,120,1
3919,20,10,11,8,1,9,24,37.5,15,19,1,18,10,30,9,0
3920,20,13,8,8,4,12,36,33.3,24,17,1,16,10,30,9,0
3921,7,3,3,2,2,5,15,33.3,10,5,1,4,5,12,2,0
3922,26,13,11,10,5,14,23,60.9,9,22,9,13,12,38,18,0
3923,17,10,9,6,2,7,15,46.7,8,18,2,16,8,25,14,0
3924,31,18,17,10,4,12,23,52.2,11,15,5,10,7,38,47,0
3925,13,7,5,7,1,5,11,45.5,6,22,12,10,6,19,33,0
3926,35,23,16,17,2,9,21,42.9,12,12,2,10,5,40,7,0
3927,21,14,12,7,2,12,19,63.2,7,17,4,13,6,27,24,0
3928,0,0,0,0,0,0,1,0.0,1,0,0,0,0,0,1,0
3929,7,4,3,4,0,2,3,66.7,1,1,0,1,2,9,0,0
3930,3,1,3,0,0,2,6,33.3,4,0,0,0,6,9,1,0
3931,2,1,0,1,1,1,2,50.0,1,3,1,2,0,2,2,0
3932,5,2,2,1,2,1,3,33.3,2,2,1,1,1,6,2,0
3933,6,2,3,2,1,1,2,50.0,1,3,0,3,1,7,6,0
3934,7,3,3,3,1,2,3,66.7,1,0,0,0,1,8,0,0
3935,0,0,0,0,0,0,1,0.0,1,1,1,0,0,0,0,0
3936,0,0,0,0,0,0,1,0.0,1,0,0,0,0,0,0,0
3937,1,0,1,0,0,1,1,100.0,0,3,0,3,0,1,19,1
3938,61,42,46,14,1,27,48,56.3,21,82,56,26,56,117,191,2
3939,66,32,42,22,2,45,62,72.6,17,51,36,15,50,116,163,2
3940,83,44,32,38,13,35,82,42.7,47,45,14,31,45,128,47,1
3941,44,27,16,14,14,24,55,43.6,31,44,7,37,22,66,37,0
3942,43,27,20,14,9,18,46,39.1,28,23,3,20,15,58,19,0
3943,69,38,46,21,2,41,66,62.1,25,36,11,25,36,105,92,0
3944,53,38,28,19,6,30,54,55.6,24,24,6,18,22,75,50,3
3945,13,6,2,6,5,2,15,13.3,13,14,4,10,4,17,38,0
3946,37,22,12,12,13,17,49,34.7,32,25,5,20,12,49,24,0
3947,73,44,32,27,14,29,46,63.0,17,24,7,17,28,101,16,0
3948,71,38,32,31,8,21,42,50.0,21,25,6,19,21,92,31,0
3949,30,20,17,8,5,15,28,53.6,13,14,8,6,16,46,57,0
3950,34,24,21,11,2,14,37,37.8,23,14,3,11,9,43,33,0
3951,14,6,1,6,7,4,12,33.3,8,11,0,11,1,15,14,0
3952,17,14,10,3,4,11,16,68.8,5,12,4,8,7,24,26,1
3953,6,4,2,3,1,1,4,25.0,3,4,0,4,3,9,0,0
3954,7,3,3,3,1,1,7,14.3,6,5,4,1,5,12,18,1
3955,7,4,2,3,2,3,13,23.1,10,10,1,9,3,10,4,1
3956,2,0,1,0,1,2,3,66.7,1,2,0,2,1,3,0,0
3957,9,7,3,5,1,5,9,55.6,4,5,1,4,1,10,0,0
3958,3,2,2,1,0,1,5,20.0,4,4,1,3,1,4,2,0
3959,0,0,0,0,0,0,1,0.0,1,2,0,2,0,0,1,0
3960,0,0,0,0,0,0,0,0.0,0,0,0,0,0,0,0,0
3961,0,0,0,0,0,0,0,0.0,0,0,0,0,0,0,0,0
3962,0,0,0,0,0,0,0,0.0,0,0,0,0,0,0,0,0
3963,1,1,1,0,0,1,5,20.0,4,1,0,1,0,1,17,1
3964,63,38,29,25,9,32,64,50.0,32,35,9,26,36,99,64,3
3965,81,50,42,31,8,32,87,36.8,55,48,6,42,54,135,50,0
3966,38,20,24,12,2,19,29,65.5,10,46,30,16,44,82,141,4
3967,28,16,13,10,5,5,20,25.0,15,24,3,21,9,37,15,0
3968,35,23,22,13,0,9,20,45.0,11,40,24,16,43,78,170,3
3969,54,32,25,22,7,26,95,27.4,69,41,6,35,23,77,25,1
3970,48,31,34,9,5,27,54,50.0,27,15,3,12,19,67,71,0
3971,15,10,6,6,3,5,19,26.3,14,26,2,24,7,22,13,0
3972,38,21,25,9,4,23,36,63.9,13,26,11,15,25,63,79,1
3973,15,5,2,7,6,6,14,42.9,8,5,1,4,10,25,18,0
3974,17,7,5,11,1,7,15,46.7,8,10,2,8,7,24,23,0
3975,26,15,12,12,2,17,22,77.3,5,21,13,8,13,39,63,1
3976,45,20,26,18,1,24,40,60.0,16,23,6,17,16,61,41,1
3977,10,7,4,5,1,3,13,23.1,10,11,0,11,2,12,3,0
3978,17,12,15,1,1,11,19,57.9,8,9,5,4,12,29,40,0
3979,37,24,9,23,5,16,29,55.2,13,15,7,8,23,60,17,0
3980,16,9,9,3,4,7,7,100.0,0,7,3,4,3,19,10,0
3981,29,17,13,9,7,14,40,35.0,26,23,1,22,11,40,10,1
3982,28,19,19,7,2,17,31,54.8,14,9,2,7,5,33,12,0
3983,17,11,6,8,3,7,17,41.2,10,17,4,13,6,23,5,0
3984,7,5,3,3,1,6,7,85.7,1,8,3,5,5,12,5,1
3985,3,1,1,2,0,0,5,0.0,5,2,0,2,1,4,4,0
3986,4,4,2,2,0,1,5,20.0,4,5,1,4,3,7,6,0
3987,0,0,0,0,0,0,0,0.0,0,0,0,0,0,0,0,0
3988,3,0,2,1,0,2,4,50.0,2,7,0,7,1,4,0,1
3989,2,1,0,1,1,0,0,0.0,0,0,0,0,0,2,0,0
3990,0,0,0,0,0,0,0,0.0,0,0,0,0,0,0,1,0
3991,36,24,6,20,10,14,33,42.4,19,31,8,23,17,53,21,0
3992,50,31,36,13,1,19,33,57.6,14,41,24,17,37,87,188,0
3993,33,19,20,6,7,17,36,47.2,19,22,2,20,8,41,20,1
3994,66,39,39,21,6,19,34,55.9,15,42,15,27,21,87,44,1
3995,18,8,4,5,9,7,28,25.0,21,16,1,15,7,25,12,1
3996,7,4,1,4,2,3,9,33.3,6,11,3,8,1,8,26,0
3997,36,18,22,12,2,21,46,45.7,25,33,8,25,35,71,42,0
3998,47,31,31,12,4,29,41,70.7,12,19,3,16,18,65,51,1
3999,27,13,16,10,1,14,29,48.3,15,12,6,6,26,53,32,0
4000,63,34,35,27,1,23,48,47.9,25,31,5,26,18,81,24,0
4001,69,40,42,18,9,35,56,62.5,21,44,13,31,22,91,53,0
4002,46,29,36,9,1,22,40,55.0,18,32,21,11,25,71,90,0
4003,0,0,0,0,0,0,0,0.0,0,0,0,0,0,0,8,4
4004,0,0,0,0,0,0,0,0.0,0,0,0,0,0,0,11,1
4005,42,25,33,9,0,20,25,80.0,5,19,12,7,14,56,51,0
4006,26,14,20,6,0,15,24,62.5,9,34,13,21,14,40,49,0
4007,42,23,25,13,4,12,29,41.4,17,24,7,17,16,58,21,0
4008,9,7,1,4,4,1,2,50.0,1,7,2,5,1,10,9,0
4009,20,14,9,11,0,5,11,45.5,6,10,3,7,9,29,36,1
4010,22,19,12,8,2,16,29,55.2,13,8,3,5,9,31,31,1
4011,10,3,9,1,0,5,8,62.5,3,12,8,4,13,23,42,1
4012,6,4,5,0,1,0,0,0.0,0,6,0,6,2,8,4,0
4013,11,7,9,1,1,8,9,88.9,1,6,0,6,1,12,21,0
4014,0,0,0,0,0,0,1,0.0,1,0,0,0,0,0,1,0
4015,7,5,6,1,0,3,6,50.0,3,5,4,1,3,10,32,1
4016,4,0,3,1,0,2,3,66.7,1,6,4,2,5,9,27,0
4017,12,9,9,3,0,9,12,75.0,3,4,1,3,4,16,12,0
4018,4,1,1,1,2,2,4,50.0,2,4,1,3,0,4,0,0
4019,7,3,4,0,3,3,6,50.0,3,3,0,3,2,9,0,0
4020,8,5,3,3,2,1,4,25.0,3,4,1,3,2,10,10,0
4021,0,0,0,0,0,0,1,0.0,1,1,0,1,1,1,0,0
4022,0,0,0,0,0,0,0,0.0,0,1,0,1,0,0,0,0
4023,0,0,0,0,0,0,0,0.0,0,0,0,0,0,0,0,0
4024,2,1,2,0,0,2,6,33.3,4,1,0,1,0,2,14,2
4025,63,40,29,18,16,37,82,45.1,45,51,9,42,31,94,43,4
4026,15,8,4,6,5,9,15,60.0,6,24,5,19,1,16,53,0
4027,47,19,16,21,10,11,48,22.9,37,25,9,16,25,72,51,2
4028,54,22,33,20,1,19,30,63.3,11,39,27,12,57,111,140,1
4029,41,22,21,19,1,16,27,59.3,11,37,20,17,31,72,92,0
4030,52,28,23,21,8,24,45,53.3,21,22,11,11,16,68,56,2
4031,50,33,30,19,1,22,35,62.9,13,33,15,18,25,75,60,1
4032,17,10,10,7,0,12,22,54.5,10,14,3,11,7,24,34,2
4033,36,22,19,13,4,15,33,45.5,18,30,6,24,8,44,11,1
4034,37,23,17,14,6,12,26,46.2,14,25,18,7,18,55,78,1
4035,4,1,1,0,3,1,12,8.3,11,13,2,11,6,10,25,0
4036,29,18,14,12,3,17,24,70.8,7,23,13,10,11,40,14,0
4037,30,17,14,11,5,11,39,28.2,28,24,3,21,11,41,15,1
4038,21,13,11,2,8,13,27,48.1,14,12,0,12,5,26,10,0
4039,25,16,17,6,2,15,22,68.2,7,23,13,10,23,48,68,0
4040,40,24,24,14,2,24,42,57.1,18,23,6,17,11,51,11,1
4041,19,12,7,7,5,7,18,38.9,11,20,1,19,8,27,22,0
4042,13,5,6,6,1,5,9,55.6,4,15,7,8,9,22,16,3
4043,11,5,6,4,1,5,11,45.5,6,12,7,5,8,19,20,0
4044,8,6,4,3,1,2,7,28.6,5,2,0,2,4,12,22,0
4045,10,6,7,3,0,5,12,41.7,7,3,0,3,1,11,13,0
4046,6,5,4,2,0,4,4,100.0,0,9,6,3,8,14,29,0
4047,16,10,8,4,4,9,16,56.3,7,7,1,6,1,17,14,0
4048,7,2,2,4,1,2,3,66.7,1,6,1,5,0,7,3,0
4049,0,0,0,0,0,0,1,0.0,1,0,0,0,0,0,0,0
4050,0,0,0,0,0,0,0,0.0,0,0,0,0,0,0,2,0
4051,1,0,1,0,0,0,0,0.0,0,0,0,0,0,1,0,0
4052,76,46,35,36,5,34,58,58.6,24,49,20,29,23,99,60,2
4053,39,20,22,14,3,11,26,42.3,15,41,30,11,35,74,158,2
4054,2,1,2,0,0,2,2,100.0,0,0,0,0,1,3,18,1
4055,27,18,1,15,11,7,25,28.0,18,23,10,13,9,36,10,0
4056,64,34,36,22,6,43,86,50.0,43,44,6,38,12,76,47,4
4057,35,20,19,14,2,17,35,48.6,18,27,11,16,19,54,78,0
4058,17,13,8,5,4,6,22,27.3,16,26,2,24,6,23,14,0
4059,61,35,23,28,10,27,37,73.0,10,33,8,25,34,95,40,1
4060,42,29,15,22,5,26,46,56.5,20,31,19,12,15,57,26,1
4061,19,10,5,6,8,6,17,35.3,11,13,3,10,3,22,34,0
4062,9,4,4,3,2,7,21,33.3,14,16,2,14,7,16,23,0
4063,27,10,15,12,0,18,32,56.3,14,21,10,11,27,54,56,0
4064,35,17,18,13,4,14,27,51.9,13,22,7,15,19,54,43,1
4065,35,20,22,12,1,14,24,58.3,10,22,15,7,16,51,68,1
4066,7,4,2,5,0,2,10,20.0,8,13,0,13,2,9,0,0
4067,13,4,6,5,2,7,16,43.8,9,14,0,14,16,29,16,0
4068,12,5,4,7,1,1,10,10.0,9,13,6,7,12,24,38,2
4069,1,1,1,0,0,1,1,100.0,0,0,0,0,0,1,10,4
4070,10,5,3,5,2,3,6,50.0,3,9,3,6,1,11,2,0
4071,12,5,6,4,2,8,17,47.1,9,8,6,2,4,16,25,2
4072,14,9,7,4,3,7,13,53.8,6,11,1,10,1,15,8,0
4073,10,6,6,4,0,3,4,75.0,1,9,3,6,9,19,26,0
4074,17,14,7,5,5,8,16,50.0,8,11,2,9,1,18,10,0
4075,4,2,2,2,0,2,4,50.0,2,10,5,5,6,10,21,0
4076,10,6,9,1,0,8,18,44.4,10,5,0,5,1,11,1,0
4077,1,0,1,0,0,0,4,0.0,4,2,0,2,0,1,1,1
4078,3,2,2,1,0,0,0,0.0,0,1,0,1,0,3,0,0
4079,2,1,0,0,2,1,4,25.0,3,1,0,1,0,2,3,0
4080,2,0,0,2,0,1,3,33.3,2,0,0,0,1,3,1,0
4081,0,0,0,0,0,0,0,0.0,0,1,0,1,0,0,0,0
4082,1,1,1,0,0,0,0,0.0,0,1,0,1,0,1,0,0
4083,39,21,17,15,7,16,59,27.1,43,33,9,24,29,68,35,0
4084,66,36,43,21,2,35,70,50.0,35,42,11,31,32,98,97,0
4085,43,28,29,14,0,25,39,64.1,14,49,33,16,33,76,132,2
4086,125,76,59,51,15,41,74,55.4,33,57,17,40,32,157,75,1
4087,64,36,48,14,2,30,49,61.2,19,43,26,17,35,99,137,2
4088,5,3,5,0,0,5,6,83.3,1,0,0,0,0,5,18,6
4089,47,30,31,13,3,21,43,48.8,22,41,22,19,35,82,153,3
4090,18,13,6,6,6,8,18,44.4,10,22,3,19,1,19,11,0
4091,32,21,9,13,10,13,33,39.4,20,20,0,20,11,43,18,0
4092,41,26,18,18,5,20,47,42.6,27,24,9,15,21,62,39,0
4093,17,7,4,7,6,5,12,41.7,7,18,2,16,5,22,28,0
4094,22,9,11,9,2,8,17,47.1,9,18,2,16,8,30,30,0
4095,9,4,4,4,1,4,10,40.0,6,9,3,6,3,12,12,0
4096,22,13,7,11,4,9,21,42.9,12,13,1,12,14,36,20,0
4097,18,10,10,7,1,6,15,40.0,9,14,8,6,10,28,33,0
4098,23,14,11,8,4,7,15,46.7,8,17,7,10,15,38,9,0
4099,20,9,13,6,1,8,14,57.1,6,23,5,18,10,30,27,0
4100,2,2,1,0,1,1,2,50.0,1,3,1,2,2,4,9,0
4101,0,0,0,0,0,0,1,0.0,1,1,0,1,0,0,9,1
4102,12,7,5,6,1,5,12,41.7,7,12,5,7,11,23,40,0
4103,17,9,10,5,2,10,14,71.4,4,6,1,5,7,24,20,1
4104,6,4,4,2,0,4,11,36.4,7,10,4,6,13,19,39,1
4105,21,10,13,5,3,8,15,53.3,7,10,4,6,5,26,15,0
4106,11,6,5,2,4,4,10,40.0,6,7,1,6,5,16,7,0
4107,4,2,1,2,1,0,4,0.0,4,4,1,3,1,5,1,0
4108,5,1,1,2,2,0,2,0.0,2,2,0,2,1,6,2,0
4109,7,2,4,3,0,2,9,22.2,7,9,4,5,5,12,17,0
4110,10,5,4,3,3,3,9,33.3,6,2,1,1,3,13,6,1
4111,1,1,1,0,0,0,1,0.0,1,2,0,2,1,2,2,0
4112,1,0,0,1,0,0,1,0.0,1,0,0,0,0,1,1,0
4113,1,0,1,0,0,1,2,50.0,1,2,0,2,0,1,0,0
4114,0,0,0,0,0,0,0,0.0,0,1,0,1,0,0,0,0
4115,0,0,0,0,0,0,0,0.0,0,0,0,0,0,0,0,0
4116,0,0,0,0,0,0,0,0.0,0,0,0,0,0,0,0,0
4117,0,0,0,0,0,0,0,0.0,0,0,0,0,0,0,0,0
4118,51,32,33,14,4,27,39,69.2,12,37,17,20,46,97,111,0
4119,42,24,8,23,11,17,34,50.0,17,22,4,18,12,54,27,0
4120,0,0,0,0,0,0,1,0.0,1,0,0,0,0,0,12,0
4121,34,22,10,10,14,17,42,40.5,25,18,0,18,15,49,11,0
4122,46,27,25,14,7,26,57,45.6,31,29,4,25,36,82,31,0
4123,56,38,17,33,6,24,39,61.5,15,24,2,22,19,75,23,0
4124,10,6,7,2,1,4,14,28.6,10,16,11,5,26,36,82,0
4125,25,16,3,17,5,7,16,43.8,9,26,3,23,4,29,16,0
4126,27,19,8,13,6,15,35,42.9,20,16,2,14,6,33,2,0
4127,46,33,22,20,4,25,41,61.0,16,27,3,24,11,57,7,2
4128,15,13,8,6,1,8,13,61.5,5,18,4,14,17,32,27,0
4129,33,22,9,16,8,15,33,45.5,18,22,6,16,12,45,15,0
4130,8,8,2,5,1,3,7,42.9,4,8,0,8,5,13,2,0
4131,10,6,6,1,3,5,16,31.3,11,13,0,13,6,16,8,1
4132,20,17,5,12,3,14,26,53.8,12,13,0,13,7,27,2,0
4133,7,4,6,1,0,5,5,100.0,0,6,4,2,2,9,14,0
4134,15,10,10,5,0,10,14,71.4,4,7,3,4,4,19,12,0
4135,12,9,8,3,1,6,11,54.5,5,8,4,4,7,19,6,0
4136,12,6,4,6,2,6,14,42.9,8,11,2,9,16,28,12,0
4137,7,4,1,5,1,3,9,33.3,6,9,2,7,6,13,4,0
4138,1,1,1,0,0,1,1,100.0,0,1,0,1,0,1,5,1
4139,1,0,1,0,0,0,1,0.0,1,1,1,0,2,3,4,0
4140,0,0,0,0,0,0,0,0.0,0,1,0,1,3,3,2,0
4141,1,1,0,0,1,0,1,0.0,1,0,0,0,0,1,2,0
4142,1,1,0,1,0,0,0,0.0,0,1,0,1,1,2,0,0
4143,0,0,0,0,0,0,0,0.0,0,0,0,0,0,0,0,0
4144,1,1,1,0,0,0,0,0.0,0,0,0,0,0,1,0,0
4145,0,0,0,0,0,0,0,0.0,0,0,0,0,0,0,0,0
4146,0,0,0,0,0,0,0,0.0,0,0,0,0,0,0,0,0
4147,0,0,0,0,0,0,2,0.0,2,0,0,0,0,0,8,3
4148,77,47,14,37,26,24,67,35.8,43,39,1,38,19,96,10,0
4149,46,25,33,13,0,28,45,62.2,17,28,18,10,33,79,133,1
4150,49,38,20,25,4,23,59,39.0,36,44,2,42,50,99,30,0
4151,46,30,22,16,8,33,73,45.2,40,38,1,37,26,72,10,0
4152,43,30,28,14,1,32,54,59.3,22,30,10,20,33,76,74,2
4153,62,42,29,20,13,38,63,60.3,25,35,6,29,30,92,32,0
4154,63,44,38,21,4,37,64,57.8,27,41,12,29,42,105,68,1
4155,38,30,9,23,6,24,44,54.5,20,22,6,16,21,59,13,0
4156,11,9,1,4,6,5,11,45.5,6,14,1,13,7,18,17,0
4157,17,8,2,6,9,9,28,32.1,19,9,0,9,4,21,0,0
4158,38,25,13,19,6,19,31,61.3,12,27,1,26,11,49,8,0
4159,24,16,12,11,1,14,25,56.0,11,17,11,6,23,47,63,3
4160,4,4,2,1,1,1,2,50.0,1,5,1,4,3,7,10,0
4161,37,22,10,20,7,14,29,48.3,15,18,3,15,17,54,14,0
4162,32,18,12,14,6,17,36,47.2,19,16,0,16,13,45,10,1
4163,6,3,4,1,1,2,6,33.3,4,8,3,5,4,10,17,0
4164,2,0,1,1,0,1,3,33.3,2,2,1,1,1,3,2,0
4165,13,12,7,5,1,4,9,44.4,5,4,0,4,3,16,3,0
4166,1,1,1,0,0,0,3,0.0,3,4,0,4,4,5,3,0
4167,2,2,0,2,0,1,8,12.5,7,2,0,2,4,6,3,0
4168,0,0,0,0,0,0,0,0.0,0,0,0,0,0,0,1,0
4169,1,1,0,1,0,1,1,100.0,0,0,0,0,1,2,2,0
4170,7,5,3,4,0,3,4,75.0,1,1,0,1,0,7,1,0
4171,0,0,0,0,0,0,0,0.0,0,0,0,0,0,0,0,0
4172,0,0,0,0,0,0,0,0.0,0,0,0,0,0,0,0,0
4173,43,29,30,11,2,18,30,60.0,12,35,24,11,22,65,127,1
4174,13,8,3,6,4,4,16,25.0,12,18,3,15,4,17,29,0
4175,21,10,10,10,1,7,12,58.3,5,29,22,7,22,43,120,4
4176,17,8,8,6,3,8,25,32.0,17,20,1,19,10,27,16,0
4177,34,16,14,19,1,19,40,47.5,21,36,12,24,21,55,50,0
4178,0,0,0,0,0,0,3,0.0,3,1,0,1,0,0,6,1
4179,41,19,25,11,5,21,41,51.2,20,27,9,18,16,57,70,0
4180,65,39,24,32,9,32,62,51.6,30,38,2,36,40,105,21,1
4181,53,38,17,25,11,23,40,57.5,17,24,6,18,14,67,12,0
4182,34,19,19,9,6,17,28,60.7,11,11,1,10,25,59,40,0
4183,41,31,14,14,13,16,32,50.0,16,20,2,18,8,49,10,0
4184,32,16,11,19,2,6,21,28.6,15,18,2,16,11,43,12,0
4185,21,15,12,6,3,8,20,40.0,12,12,3,9,16,37,34,0
4186,42,20,21,14,7,18,33,54.5,15,20,4,16,25,67,26,1
4187,0,0,0,0,0,0,0,0.0,0,0,0,0,0,0,1,0
4188,19,15,16,3,0,10,15,66.7,5,12,4,8,11,30,20,0
4189,12,5,9,1,2,9,14,64.3,5,6,2,4,5,17,21,1
4190,17,8,10,6,1,12,14,85.7,2,2,0,2,12,29,8,0
4191,6,2,2,1,3,4,6,66.7,2,3,1,2,1,7,2,0
4192,14,8,3,6,5,9,22,40.9,13,5,0,5,3,17,0,0
4193,10,4,3,4,3,4,10,40.0,6,2,1,1,1,11,8,0
4194,3,3,1,0,2,2,11,18.2,9,3,1,2,4,7,2,0
4195,5,4,1,3,1,2,5,40.0,3,1,1,0,6,11,3,1
4196,3,1,1,2,0,1,1,100.0,0,2,2,0,1,4,4,0
4197,0,0,0,0,0,0,0,0.0,0,2,0,2,2,2,0,0
4198,1,1,1,0,0,1,5,20.0,4,1,0,1,1,2,2,0
4199,0,0,0,0,0,0,0,0.0,0,0,0,0,0,0,1,0
4200,0,0,0,0,0,0,1,0.0,1,1,0,1,0,0,0,0
4201,1,1,0,1,0,0,0,0.0,0,1,0,1,1,2,1,0
4202,0,0,0,0,0,0,0,0.0,0,0,0,0,0,0,0,0
4203,0,0,0,0,0,0,0,0.0,0,0,0,0,0,0,0,0
4204,0,0,0,0,0,0,0,0.0,0,0,0,0,0,0,0,0
4205,0,0,0,0,0,0,0,0.0,0,0,0,0,0,0,22,1
4206,50,36,28,18,4,33,47,70.2,14,33,13,20,43,93,118,0
4207,16,7,1,7,8,5,12,41.7,7,19,0,19,3,19,8,0
4208,58,40,26,17,15,26,63,41.3,37,51,5,46,20,78,36,0
4209,35,25,17,17,1,10,19,52.6,9,21,10,11,42,77,73,1
4210,54,28,15,31,8,29,81,35.8,52,37,3,34,25,79,49,0
4211,37,21,14,16,7,13,28,46.4,15,38,6,32,30,67,28,0
4212,68,45,42,16,10,52,101,51.5,49,45,5,40,35,103,38,0
4213,62,40,35,24,3,34,55,61.8,21,18,3,15,28,90,69,3
4214,49,29,23,18,8,18,37,48.6,19,34,5,29,13,62,19,0
4215,10,6,1,3,6,5,16,31.3,11,14,0,14,1,11,2,0
4216,16,11,2,7,7,5,16,31.3,11,20,0,20,8,24,3,0
4217,29,14,10,16,3,17,37,45.9,20,25,1,24,12,41,24,1
4218,35,27,21,12,2,21,37,56.8,16,17,5,12,18,53,29,1
4219,19,8,5,12,2,11,31,35.5,20,16,0,16,5,24,5,0
4220,17,12,9,8,0,11,24,45.8,13,9,2,7,11,28,30,1
4221,11,10,7,3,1,7,11,63.6,4,9,1,8,7,18,10,0
4222,18,8,4,12,2,11,13,84.6,2,7,0,7,8,26,2,0
4223,4,3,1,2,1,2,6,33.3,4,10,0,10,1,5,4,0
4224,15,11,7,3,5,5,15,33.3,10,19,2,17,9,24,10,0
4225,10,8,2,4,4,4,17,23.5,13,8,0,8,3,13,6,0
4226,6,4,3,2,1,2,4,50.0,2,3,0,3,0,6,5,0
4227,11,8,3,6,2,5,11,45.5,6,7,1,6,4,15,10,0
4228,0,0,0,0,0,0,0,0.0,0,2,0,2,1,1,1,0
4229,2,2,1,1,0,1,3,33.3,2,4,1,3,0,2,0,0
4230,0,0,0,0,0,0,0,0.0,0,1,0,1,0,0,0,0
4231,0,0,0,0,0,0,0,0.0,0,0,0,0,0,0,1,0
4232,0,0,0,0,0,0,0,0.0,0,1,0,1,1,1,8,3
4233,52,34,20,16,16,23,40,57.5,17,24,1,23,7,59,12,0
4234,53,31,16,27,10,22,41,53.7,19,31,9,22,29,82,52,0
4235,37,21,22,12,3,15,23,65.2,8,14,3,11,35,72,62,1
4236,25,16,12,11,2,13,27,48.1,14,27,4,23,18,43,33,0
4237,20,13,11,9,0,5,10,50.0,5,33,20,13,26,46,86,1
4238,14,9,3,6,5,5,10,50.0,5,10,1,9,6,20,8,0
4239,49,28,27,13,9,15,24,62.5,9,19,6,13,26,75,35,0
4240,31,22,22,9,0,11,17,64.7,6,31,19,12,19,50,68,1
4241,31,15,19,12,0,12,37,32.4,25,21,2,19,20,51,26,0
4242,20,13,10,8,2,10,18,55.6,8,8,3,5,22,42,25,0
4243,34,23,8,18,8,14,26,53.8,12,15,0,15,7,41,6,0
4244,8,4,0,6,2,2,7,28.6,5,5,0,5,4,12,8,0
4245,34,22,20,9,5,19,29,65.5,10,21,4,17,14,48,23,1
4246,30,22,11,12,7,23,41,56.1,18,20,4,16,14,44,22,0
4247,25,15,8,9,8,6,24,25.0,18,11,0,11,5,30,3,0
4248,6,2,1,3,2,3,14,21.4,11,10,0,10,6,12,33,0
4249,5,2,0,3,2,1,4,25.0,3,8,0,8,4,9,3,0
4250,1,1,0,0,1,0,3,0.0,3,10,0,10,2,3,5,0
4251,7,3,6,1,0,4,7,57.1,3,6,0,6,9,16,19,0
4252,6,4,4,2,0,2,4,50.0,2,5,2,3,9,15,20,0
4253,6,5,1,5,0,1,7,14.3,6,2,0,2,1,7,0,0
4254,1,0,0,0,1,0,0,0.0,0,3,0,3,2,3,0,0
4255,0,0,0,0,0,0,0,0.0,0,0,0,0,0,0,0,0
4256,3,3,2,0,1,2,4,50.0,2,0,0,0,1,4,0,0
4257,1,1,0,1,0,0,0,0.0,0,0,0,0,0,1,1,0
4258,0,0,0,0,0,0,3,0.0,3,0,0,0,0,0,8,1
4259,34,19,19,13,2,16,29,55.2,13,32,18,14,24,58,112,0
4260,25,18,9,6,10,11,22,50.0,11,12,4,8,7,32,7,0
4261,34,16,12,20,2,21,33,63.6,12,19,4,15,10,44,19,2
4262,69,38,35,24,10,40,76,52.6,36,31,2,29,33,102,36,1
4263,36,23,19,15,2,16,41,39.0,25,27,6,21,24,60,35,0
4264,56,44,18,25,13,11,20,55.0,9,24,0,24,21,77,10,0
4265,27,18,20,6,1,17,38,44.7,21,18,2,16,12,39,32,1
4266,48,27,28,20,0,26,47,55.3,21,25,4,21,33,81,16,0
4267,14,9,8,6,0,8,12,66.7,4,19,13,6,26,40,54,0
4268,15,8,3,8,4,7,14,50.0,7,6,0,6,9,24,11,0
4269,22,14,12,7,3,11,33,33.3,22,12,0,12,3,25,6,0
4270,22,14,9,10,3,12,18,66.7,6,9,4,5,17,39,30,0
4271,28,19,17,11,0,11,19,57.9,8,14,7,7,30,58,41,1
4272,37,23,18,15,4,18,41,43.9,23,8,1,7,15,52,15,0
4273,23,15,6,14,3,9,22,40.9,13,17,2,15,3,26,4,0
4274,7,4,2,4,1,3,7,42.9,4,2,1,1,3,10,3,0
4275,0,0,0,0,0,0,0,0.0,0,1,0,1,0,0,6,0
4276,10,7,1,8,1,5,11,45.5,6,4,0,4,1,11,1,0
4277,3,3,1,1,1,1,4,25.0,3,2,0,2,0,3,2,0
4278,5,3,3,1,1,3,9,33.3,6,3,2,1,0,5,2,0
4279,4,2,0,3,1,3,7,42.9,4,0,0,0,3,7,0,0
4280,0,0,0,0,0,0,1,0.0,1,0,0,0,1,1,1,0
4281,11,6,5,3,3,3,3,100.0,0,2,0,2,2,13,3,0
4282,3,3,1,2,0,1,4,25.0,3,2,0,2,0,3,0,0
4283,3,2,2,1,0,0,2,0.0,2,0,0,0,0,3,0,0
4284,1,1,0,1,0,1,1,100.0,0,0,0,0,0,1,0,0
4285,110,74,49,54,7,43,74,58.1,31,38,10,28,62,172,63,2
4286,86,52,44,33,9,60,84,71.4,24,36,10,26,32,118,51,0
4287,26,21,19,7,0,10,20,50.0,10,39,25,14,22,48,106,0
4288,62,39,35,21,6,37,51,72.5,14,19,8,11,30,92,78,2
4289,34,22,16,15,3,17,50,34.0,33,18,6,12,20,54,39,0
4290,48,29,31,14,3,27,45,60.0,18,26,17,9,37,85,75,0
4291,24,15,13,8,3,13,26,50.0,13,32,7,25,21,45,18,0
4292,29,16,9,18,2,17,35,48.6,18,20,1,19,18,47,6,0
4293,28,19,6,15,7,10,39,25.6,29,12,0,12,7,35,13,0
4294,16,11,2,7,7,5,11,45.5,6,13,0,13,4,20,2,0
4295,17,13,6,5,6,9,13,69.2,4,7,2,5,11,28,9,1
4296,0,0,0,0,0,0,3,0.0,3,0,0,0,0,0,4,1
4297,14,8,5,4,5,8,16,50.0,8,16,2,14,10,24,20,0
4298,0,0,0,0,0,0,0,0.0,0,0,0,0,0,0,1,0
4299,10,6,0,6,4,2,3,66.7,1,7,0,7,2,12,0,0
4300,21,14,5,9,7,8,22,36.4,14,10,1,9,4,25,2,0
4301,0,0,0,0,0,0,0,0.0,0,0,0,0,0,0,1,1
4302,8,4,4,4,0,3,4,75.0,1,5,4,1,6,14,24,0
4303,14,11,13,0,1,11,12,91.7,1,5,1,4,9,23,19,0
4304,2,1,1,0,1,0,2,0.0,2,0,0,0,0,2,5,0
4305,2,1,0,2,0,0,3,0.0,3,4,0,4,6,8,0,0
4306,11,8,5,5,1,9,12,75.0,3,2,1,1,7,18,3,0
4307,2,1,2,0,0,0,1,0.0,1,5,4,1,5,7,12,1
4308,0,0,0,0,0,0,2,0.0,2,0,0,0,0,0,1,0
4309,3,1,0,1,2,1,3,33.3,2,0,0,0,0,3,0,0
4310,2,1,2,0,0,1,1,100.0,0,2,1,1,4,6,5,1
4311,0,0,0,0,0,0,1,0.0,1,0,0,0,1,1,1,0
4312,2,1,0,2,0,0,0,0.0,0,2,0,2,1,3,0,0
4313,2,1,2,0,0,0,0,0.0,0,0,0,0,1,3,1,0
4314,0,0,0,0,0,0,1,0.0,1,0,0,0,0,0,1,0
4315,0,0,0,0,0,0,0,0.0,0,0,0,0,0,0,1,0
4316,0,0,0,0,0,0,1,0.0,1,0,0,0,0,0,10,2
4317,41,28,25,13,3,23,49,46.9,26,44,12,32,25,66,25,0
4318,72,51,39,24,9,40,65,61.5,25,38,8,30,25,97,56,0
4319,45,18,20,15,10,29,69,42.0,40,26,4,22,25,70,22,0
4320,14,10,9,5,0,9,15,60.0,6,39,29,10,17,31,99,1
4321,39,21,18,16,5,24,51,47.1,27,25,4,21,15,54,20,0
4322,26,16,17,7,2,16,31,51.6,15,40,30,10,27,53,121,0
4323,14,8,2,11,1,5,20,25.0,15,17,6,11,5,19,24,0
4324,55,38,38,13,4,33,53,62.3,20,22,14,8,36,91,63,1
4325,25,8,13,9,3,13,24,54.2,11,9,6,3,17,42,35,0
4326,39,26,21,18,0,18,27,66.7,9,13,5,8,32,71,23,0
4327,36,20,18,14,4,19,30,63.3,11,17,7,10,25,61,42,0
4328,13,10,8,3,2,7,18,38.9,11,11,0,11,4,17,8,0
4329,11,8,7,1,3,3,10,30.0,7,10,0,10,5,16,4,0
4330,7,5,3,3,1,3,6,50.0,3,7,0,7,5,12,11,0
4331,8,4,4,3,1,0,5,0.0,5,6,0,6,2,10,6,0
4332,17,9,11,4,2,11,13,84.6,2,3,1,2,11,28,14,0
4333,2,1,0,1,1,1,4,25.0,3,2,0,2,1,3,5,0
4334,18,10,10,4,4,13,17,76.5,4,6,1,5,5,23,16,0
4335,13,7,9,4,0,5,5,100.0,0,4,2,2,6,19,3,0
4336,4,2,2,2,0,3,5,60.0,2,9,5,4,6,10,16,0
4337,0,0,0,0,0,0,0,0.0,0,0,0,0,0,0,1,0
4338,1,1,0,1,0,1,3,33.3,2,0,0,0,0,1,2,0
4339,2,0,1,1,0,1,1,100.0,0,4,1,3,3,5,12,0
4340,2,1,1,1,0,1,2,50.0,1,0,0,0,2,4,1,0
4341,1,0,0,0,1,0,0,0.0,0,2,0,2,0,1,0,0
4342,0,0,0,0,0,0,1,0.0,1,1,0,1,0,0,0,0
4343,0,0,0,0,0,0,0,0.0,0,0,0,0,0,0,0,0
4344,0,0,0,0,0,0,0,0.0,0,0,0,0,0,0,2,0
4345,30,20,17,12,1,13,31,41.9,18,42,32,10,45,75,123,1
4346,61,40,22,32,7,30,69,43.5,39,31,13,18,51,112,38,2
4347,67,41,50,16,1,38,58,65.5,20,44,18,26,31,98,74,0
4348,34,21,22,12,0,20,33,60.6,13,38,22,16,45,79,85,0
4349,38,25,22,10,6,25,35,71.4,10,31,3,28,51,89,41,0
4350,16,9,3,9,4,7,24,29.2,17,8,0,8,9,25,11,0
4351,42,29,14,25,3,17,41,41.5,24,24,0,24,23,65,11,0
4352,0,0,0,0,0,0,0,0.0,0,0,0,0,1,1,9,3
4353,15,7,7,6,2,3,16,18.8,13,6,0,6,8,23,7,0
4354,28,18,19,8,1,18,32,56.3,14,27,6,21,18,46,50,0
4355,8,5,3,3,2,3,10,30.0,7,6,0,6,6,14,10,0
4356,17,10,1,8,8,8,12,66.7,4,8,1,7,3,20,5,0
4357,26,18,11,14,1,10,17,58.8,7,15,5,10,13,39,8,0
4358,12,7,4,4,4,6,15,40.0,9,7,2,5,6,18,7,0
4359,13,9,8,4,1,7,12,58.3,5,4,1,3,6,19,9,0
4360,13,6,3,7,3,3,13,23.1,10,13,0,13,5,18,6,0
4361,1,0,1,0,0,1,1,100.0,0,0,0,0,0,1,1,0
4362,0,0,0,0,0,0,0,0.0,0,0,0,0,0,0,0,0
4363,4,2,1,2,1,3,6,50.0,3,3,0,3,0,4,7,0
4364,11,7,6,3,2,3,4,75.0,1,5,1,4,11,22,14,0
4365,1,1,1,0,0,1,2,50.0,1,1,0,1,2,3,6,0
4366,4,2,2,1,1,4,4,100.0,0,1,0,1,3,7,0,0
4367,6,1,2,2,2,2,3,66.7,1,0,0,0,0,6,1,0
4368,0,0,0,0,0,0,0,0.0,0,1,0,1,0,0,0,0
4369,0,0,0,0,0,0,1,0.0,1,0,0,0,0,0,0,0
4370,44,25,32,11,1,20,27,74.1,7,64,31,33,28,72,134,3
4371,79,38,30,41,8,27,56,48.2,29,39,14,25,54,133,50,0
4372,42,30,18,13,11,24,48,50.0,24,23,1,22,5,47,14,0
4373,39,23,31,7,1,14,18,77.8,4,28,17,11,22,61,84,0
4374,34,23,25,7,2,14,26,53.8,12,13,5,8,16,50,30,0
4375,30,18,13,11,6,15,34,44.1,19,27,7,20,7,37,47,0
4376,28,17,16,9,3,17,23,73.9,6,21,7,14,28,56,71,0
4377,11,6,7,1,3,6,14,42.9,8,13,1,12,6,17,11,0
4378,18,9,10,4,4,13,20,65.0,7,22,4,18,19,37,47,0
4379,15,8,13,2,0,7,14,50.0,7,20,10,10,26,41,61,0
4380,0,0,0,0,0,0,0,0.0,0,0,0,0,0,0,13,4
4381,30,10,19,7,4,15,41,36.6,26,24,6,18,16,46,63,1
4382,10,7,0,8,2,1,8,12.5,7,16,0,16,2,12,0,0
4383,3,2,1,0,2,2,4,50.0,2,9,1,8,1,4,8,0
4384,0,0,0,0,0,0,1,0.0,1,0,0,0,0,0,3,0
4385,8,6,0,5,3,2,9,22.2,7,10,2,8,3,11,12,0
4386,26,15,10,12,4,9,17,52.9,8,11,2,9,10,36,13,0
4387,9,5,5,4,0,7,18,38.9,11,5,1,4,1,10,5,0
4388,6,1,1,4,1,3,9,33.3,6,7,0,7,2,8,3,0
4389,4,4,4,0,0,3,8,37.5,5,2,0,2,2,6,1,0
4390,0,0,0,0,0,0,0,0.0,0,0,0,0,0,0,2,0
4391,14,7,3,7,4,10,16,62.5,6,13,0,13,2,16,4,0
4392,5,4,3,2,0,2,4,50.0,2,2,1,1,6,11,9,0
4393,1,1,1,0,0,1,1,100.0,0,0,0,0,1,2,0,0
4394,2,1,1,1,0,1,1,100.0,0,0,0,0,1,3,0,0
4395,3,2,2,0,1,1,2,50.0,1,0,0,0,1,4,5,0
4396,2,1,1,0,1,2,2,100.0,0,1,0,1,2,4,1,0
4397,3,3,3,0,0,3,4,75.0,1,1,1,0,1,4,3,0
4398,54,37,29,20,5,28,44,63.6,16,30,8,22,34,88,60,0
4399,0,0,0,0,0,0,0,0.0,0,0,0,0,0,0,6,4
4400,30,20,16,14,0,13,25,52.0,12,28,17,11,38,68,104,0
4401,30,19,8,16,6,12,29,41.4,17,31,11,20,13,43,21,1
4402,51,29,22,24,5,20,48,41.7,28,14,2,12,16,67,44,1
4403,57,39,38,17,2,29,56,51.8,27,39,20,19,63,120,122,1
4404,32,24,22,4,6,17,31,54.8,14,27,4,23,25,57,36,1
4405,35,21,17,10,8,17,42,40.5,25,38,2,36,10,45,8,0
4406,30,19,11,16,3,15,27,55.6,12,24,6,18,18,48,32,0
4407,27,17,8,16,3,15,31,48.4,16,25,3,22,10,37,5,0
4408,27,17,20,4,3,12,15,80.0,3,23,2,21,23,50,36,1
4409,18,8,8,8,2,8,10,80.0,2,19,7,12,19,37,40,0
4410,11,6,5,5,1,5,13,38.5,8,2,0,2,3,14,2,0
4411,18,12,3,10,5,8,24,33.3,16,4,0,4,5,23,2,0
4412,14,9,10,4,0,3,9,33.3,6,4,0,4,5,19,13,0
4413,4,2,2,2,0,2,2,100.0,0,5,1,4,0,4,3,0
4414,26,20,15,9,2,13,26,50.0,13,11,3,8,7,33,13,0
4415,9,6,8,1,0,6,8,75.0,2,9,7,2,11,20,27,0
4416,3,2,0,1,2,2,5,40.0,3,5,0,5,1,4,6,0
4417,9,5,2,6,1,3,16,18.8,13,13,3,10,8,17,8,0
4418,15,10,5,10,0,9,15,60.0,6,10,4,6,5,20,11,0
4419,4,4,2,1,1,1,2,50.0,1,7,0,7,4,8,4,0
4420,12,8,7,5,0,6,11,54.5,5,7,2,5,4,16,12,0
4421,0,0,0,0,0,0,0,0.0,0,0,0,0,0,0,1,1
4422,3,3,1,2,0,2,2,100.0,0,11,7,4,8,11,19,2
4423,3,2,2,1,0,0,3,0.0,3,9,2,7,0,3,3,0
4424,2,1,2,0,0,2,4,50.0,2,1,0,1,1,3,0,0
4425,0,0,0,0,0,0,1,0.0,1,2,0,2,1,1,1,0
4426,0,0,0,0,0,0,0,0.0,0,0,0,0,0,0,2,0
4427,1,0,0,0,1,0,0,0.0,0,0,0,0,0,1,0,0
4428,1,1,0,1,0,1,2,50.0,1,0,0,0,0,1,0,0
4429,1,0,1,0,0,1,2,50.0,1,0,0,0,0,1,11,1
4430,3,3,0,2,1,1,6,16.7,5,14,5,9,3,6,23,0
4431,25,13,10,10,5,12,33,36.4,21,20,2,18,10,35,13,0
4432,27,18,19,6,2,18,26,69.2,8,29,17,12,37,64,89,2
4433,29,14,13,10,6,10,14,71.4,4,18,8,10,29,58,46,0
4434,44,28,15,23,6,22,37,59.5,15,27,2,25,18,62,20,1
4435,24,15,9,13,2,9,19,47.4,10,19,2,17,11,35,19,0
4436,33,16,25,8,0,19,24,79.2,5,20,13,7,27,60,87,0
4437,54,39,31,21,2,27,59,45.8,32,24,8,16,26,80,32,0
4438,48,27,22,22,4,19,37,51.4,18,30,8,22,17,65,36,1
4439,19,13,13,6,0,11,19,57.9,8,13,8,5,22,41,78,0
4440,20,16,6,11,3,3,19,15.8,16,10,1,9,7,27,13,0
4441,25,18,16,7,2,12,22,54.5,10,10,2,8,36,61,35,0
4442,27,12,10,13,4,7,13,53.8,6,10,0,10,10,37,9,1
4443,27,15,17,9,1,14,20,70.0,6,13,5,8,20,47,42,0
4444,18,13,6,9,3,6,19,31.6,13,6,0,6,10,28,10,0
4445,18,13,6,11,1,10,14,71.4,4,7,2,5,11,29,18,0
4446,17,11,8,9,0,10,18,55.6,8,11,2,9,9,26,23,0
4447,17,12,5,12,0,8,11,72.7,3,9,5,4,9,26,11,0
4448,4,4,1,3,0,1,7,14.3,6,2,2,0,1,5,7,0
4449,2,0,0,1,1,2,6,33.3,4,6,0,6,1,3,10,0
4450,9,6,4,3,2,2,8,25.0,6,13,1,12,3,12,11,0
4451,6,4,2,1,3,1,6,16.7,5,2,0,2,1,7,3,0
4452,1,1,0,1,0,0,2,0.0,2,4,1,3,0,1,1,0
4453,3,2,2,1,0,1,2,50.0,1,0,0,0,2,5,5,0
4454,2,2,0,2,0,2,4,50.0,2,2,2,0,0,2,7,0
4455,0,0,0,0,0,0,2,0.0,2,1,1,0,0,0,2,0
4456,1,1,1,0,0,1,1,100.0,0,0,0,0,0,1,1,0
4457,7,5,4,3,0,4,4,100.0,0,1,1,0,1,8,0,0
4458,0,0,0,0,0,0,0,0.0,0,1,0,1,1,1,2,0
4459,3,3,2,0,1,3,3,100.0,0,0,0,0,2,5,2,0
4460,3,1,1,2,0,1,1,100.0,0,1,1,0,0,3,2,0
4461,1,1,1,0,0,1,1,100.0,0,3,0,3,0,1,0,0
4462,1,0,1,0,0,1,1,100.0,0,1,0,1,0,1,2,0
4463,52,37,33,18,1,24,42,57.1,18,44,23,21,37,89,109,0
4464,3,2,3,0,0,2,3,66.7,1,0,0,0,1,4,7,3
4465,60,38,26,28,6,33,64,51.6,31,40,6,34,26,86,21,0
4466,53,40,32,17,4,40,75,53.3,35,31,6,25,39,92,55,0
4467,55,29,33,17,5,23,57,40.4,34,36,8,28,25,80,27,0
4468,33,25,22,10,1,22,37,59.5,15,17,5,12,16,49,42,0
4469,26,22,8,12,6,10,30,33.3,20,21,6,15,18,44,21,1
4470,10,6,5,3,2,6,11,54.5,5,4,0,4,2,12,16,0
4471,14,11,6,7,1,4,15,26.7,11,8,1,7,1,15,7,0
4472,35,23,23,12,0,17,35,48.6,18,27,22,5,26,61,70,2
4473,23,17,5,13,5,6,19,31.6,13,15,2,13,5,28,7,0
4474,33,17,16,16,1,17,28,60.7,11,28,20,8,26,59,80,0
4475,31,19,13,16,2,17,29,58.6,12,25,4,21,21,52,13,0
4476,24,14,15,7,2,9,18,50.0,9,16,6,10,27,51,24,1
4477,11,6,7,2,2,5,10,50.0,5,1,0,1,4,15,10,0
4478,10,5,6,4,0,5,6,83.3,1,8,4,4,21,31,33,0
4479,13,9,5,8,0,9,11,81.8,2,16,0,16,5,18,0,0
4480,16,12,10,5,1,8,10,80.0,2,5,1,4,3,19,17,0
4481,3,3,0,1,2,1,4,25.0,3,3,0,3,1,4,3,0
4482,11,7,7,4,0,4,8,50.0,4,5,2,3,10,21,21,1
4483,5,3,0,2,3,3,5,60.0,2,4,1,3,4,9,6,0
4484,0,0,0,0,0,0,1,0.0,1,0,0,0,0,0,0,0
4485,14,5,2,10,2,9,14,64.3,5,4,0,4,4,18,6,0
4486,5,4,5,0,0,2,2,100.0,0,4,2,2,6,11,19,0
4487,5,4,0,4,1,1,3,33.3,2,7,1,6,0,5,2,0
4488,10,6,6,4,0,5,9,55.6,4,1,0,1,3,13,4,0
4489,3,1,2,1,0,1,3,33.3,2,0,0,0,2,5,1,0
4490,5,3,2,3,0,3,4,75.0,1,1,1,0,1,6,0,0
4491,0,0,0,0,0,0,0,0.0,0,1,1,0,2,2,1,0
4492,0,0,0,0,0,0,0,0.0,0,0,0,0,0,0,0,0
4493,41,22,32,7,2,17,25,68.0,8,45,32,13,31,72,205,2
4494,65,30,33,26,6,20,63,31.7,43,52,0,52,27,92,24,1
4495,43,24,24,15,4,22,40,55.0,18,28,8,20,21,64,24,2
4496,49,29,22,23,4,18,36,50.0,18,31,6,25,28,77,47,0
4497,60,42,42,15,3,23,52,44.2,29,32,1,31,21,81,57,0
4498,1,1,1,0,0,1,1,100.0,0,0,0,0,1,2,9,2
4499,14,8,2,6,6,6,12,50.0,6,17,1,16,3,17,4,0
4500,25,17,18,6,1,11,18,61.1,7,39,26,13,33,58,114,0
4501,16,11,2,10,4,7,19,36.8,12,10,2,8,6,22,25,0
4502,23,18,14,9,0,13,23,56.5,10,9,2,7,12,35,24,0
4503,36,21,22,12,2,18,31,58.1,13,21,11,10,30,66,45,0
4504,16,12,8,7,1,9,26,34.6,17,10,2,8,7,23,10,0
4505,23,16,19,4,0,17,21,81.0,4,21,11,10,20,43,63,1
4506,0,0,0,0,0,0,1,0.0,1,1,0,1,0,0,10,3
4507,16,9,10,4,2,7,9,77.8,2,13,6,7,17,33,46,0
4508,16,7,13,2,1,9,14,64.3,5,5,0,5,7,23,9,0
4509,27,11,19,8,0,18,37,48.6,19,17,5,12,18,45,27,0
4510,16,11,8,8,0,10,13,76.9,3,5,3,2,9,25,16,0
4511,9,8,8,1,0,8,12,66.7,4,6,6,0,8,17,28,1
4512,9,5,5,4,0,3,6,50.0,3,2,0,2,2,11,0,0
4513,12,3,7,4,1,8,13,61.5,5,8,1,7,10,22,11,0
4514,2,1,1,1,0,1,3,33.3,2,0,0,0,0,2,1,0
4515,5,3,2,3,0,3,5,60.0,2,2,0,2,1,6,2,0
4516,5,2,4,0,1,1,3,33.3,2,2,0,2,2,7,10,0
4517,2,2,2,0,0,0,1,0.0,1,1,0,1,2,4,1,0
4518,7,4,4,3,0,3,8,37.5,5,2,1,1,5,12,4,0
4519,5,2,2,3,0,3,8,37.5,5,5,0,5,2,7,5,0
4520,5,4,4,0,1,2,3,66.7,1,4,0,4,0,5,3,0
4521,2,1,2,0,0,0,0,0.0,0,2,1,1,1,3,3,0
4522,2,0,2,0,0,0,2,0.0,2,0,0,0,2,4,7,0
4523,1,1,0,0,1,0,1,0.0,1,0,0,0,1,2,1,0
4524,0,0,0,0,0,0,5,0.0,5,2,0,2,0,0,0,0
4525,0,0,0,0,0,0,1,0.0,1,1,0,1,0,0,0,0
4526,0,0,0,0,0,0,0,0.0,0,1,0,1,0,0,0,0
4527,0,0,0,0,0,0,0,0.0,0,1,1,0,1,1,0,0
4528,0,0,0,0,0,0,0,0.0,0,0,0,0,0,0,0,0
4529,1,1,1,0,0,1,1,100.0,0,0,0,0,1,2,15,1
4530,50,36,20,26,4,29,58,50.0,29,51,5,46,29,79,35,1
4531,21,10,7,9,5,9,22,40.9,13,7,2,5,6,27,24,0
4532,23,13,11,7,5,14,24,58.3,10,15,1,14,25,48,57,1
4533,15,12,8,6,1,7,22,31.8,15,15,2,13,9,24,15,1
4534,32,25,17,11,4,18,28,64.3,10,23,7,16,21,53,35,0
4535,29,17,15,12,2,6,18,33.3,12,8,0,8,7,36,7,0
4536,8,4,2,5,1,2,10,20.0,8,7,0,7,2,10,4,0
4537,47,32,23,17,7,18,46,39.1,28,21,6,15,13,60,37,0
4538,19,10,13,6,0,9,19,47.4,10,28,18,10,21,40,115,0
4539,32,16,21,10,1,14,21,66.7,7,17,3,14,16,48,45,1
4540,20,12,16,3,1,10,16,62.5,6,11,6,5,13,33,74,1
4541,25,18,19,6,0,11,18,61.1,7,21,13,8,27,52,75,2
4542,18,13,12,3,3,12,30,40.0,18,19,10,9,19,37,54,0
4543,10,5,6,4,0,4,4,100.0,0,21,14,7,14,24,56,0
4544,11,8,6,3,2,4,11,36.4,7,12,0,12,9,20,8,0
4545,12,5,7,5,0,5,8,62.5,3,14,8,6,26,38,51,0
4546,21,14,13,8,0,12,17,70.6,5,7,1,6,7,28,19,1
4547,26,13,9,14,3,9,21,42.9,12,9,1,8,4,30,5,0
4548,12,7,12,0,0,4,10,40.0,6,7,3,4,8,20,25,0
4549,17,13,13,2,2,9,14,64.3,5,7,4,3,5,22,19,0
4550,7,6,1,5,1,3,6,50.0,3,8,0,8,6,13,6,0
4551,15,9,9,5,1,7,21,33.3,14,14,4,10,4,19,11,0
4552,17,12,12,3,2,9,16,56.3,7,7,1,6,5,22,8,0
4553,5,3,3,2,0,4,4,100.0,0,9,7,2,4,9,16,0
4554,10,7,8,2,0,4,6,66.7,2,11,4,7,5,15,26,0
4555,5,5,4,1,0,4,9,44.4,5,2,0,2,1,6,9,0
4556,4,3,0,1,3,2,5,40.0,3,2,0,2,1,5,0,0
4557,5,2,4,1,0,4,6,66.7,2,3,0,3,5,10,3,0
4558,3,3,0,3,0,1,1,100.0,0,1,0,1,2,5,1,0
4559,5,4,3,1,1,4,5,80.0,1,4,0,4,2,7,3,0
4560,1,1,1,0,0,1,6,16.7,5,3,1,2,1,2,5,0
4561,0,0,0,0,0,0,1,0.0,1,1,1,0,0,0,0,0
4562,4,3,2,2,0,1,3,33.3,2,3,0,3,0,4,1,0
4563,0,0,0,0,0,0,0,0.0,0,1,0,1,0,0,1,0
4564,0,0,0,0,0,0,1,0.0,1,0,0,0,0,0,0,0
4565,0,0,0,0,0,0,0,0.0,0,0,0,0,0,0,0,0
4566,0,0,0,0,0,0,1,0.0,1,0,0,0,0,0,0,0
4567,28,19,22,6,0,14,27,51.9,13,41,32,9,33,61,168,0
4568,1,1,1,0,0,1,4,25.0,3,0,0,0,0,1,15,3
4569,24,13,8,11,5,12,28,42.9,16,15,2,13,12,36,11,0
4570,42,31,24,13,5,24,38,63.2,14,42,15,27,33,75,87,2
4571,42,25,32,9,1,27,54,50.0,27,28,16,12,41,83,90,1
4572,74,46,40,28,6,26,56,46.4,30,42,7,35,41,115,38,1
4573,55,31,25,21,9,29,57,50.9,28,41,13,28,24,79,45,0
4574,27,19,16,7,4,13,25,52.0,12,24,5,19,19,46,59,1
4575,47,26,21,24,2,25,49,51.0,24,30,8,22,28,75,52,0
4576,27,20,16,9,2,12,36,33.3,24,17,4,13,14,41,14,2
4577,21,15,11,7,3,9,30,30.0,21,11,1,10,7,28,10,1
4578,54,36,26,23,5,22,49,44.9,27,20,0,20,20,74,5,0
4579,19,12,6,8,5,7,14,50.0,7,12,2,10,3,22,8,0
4580,5,2,0,3,2,2,11,18.2,9,10,0,10,2,7,5,1
4581,23,14,18,4,1,11,21,52.4,10,16,10,6,13,36,32,3
4582,10,7,9,1,0,7,13,53.8,6,10,5,5,14,24,49,1
4583,26,14,11,8,7,11,20,55.0,9,13,0,13,6,32,11,0
4584,8,5,5,3,0,3,9,33.3,6,4,2,2,4,12,7,0
4585,1,0,0,1,0,0,0,0.0,0,4,2,2,2,3,6,0
4586,0,0,0,0,0,0,0,0.0,0,0,0,0,0,0,3,1
4587,3,3,0,2,1,2,3,66.7,1,2,1,1,3,6,8,0
4588,0,0,0,0,0,0,1,0.0,1,1,0,1,0,0,1,0
4589,6,3,1,2,3,1,4,25.0,3,5,0,5,1,7,4,0
4590,0,0,0,0,0,0,0,0.0,0,0,0,0,0,0,1,0
4591,0,0,0,0,0,0,0,0.0,0,0,0,0,0,0,0,0
4592,0,0,0,0,0,0,0,0.0,0,0,0,0,0,0,0,0
4593,16,11,3,5,8,3,6,50.0,3,13,1,12,5,21,22,0
4594,47,30,10,23,14,20,55,36.4,35,31,2,29,10,57,4,0
4595,48,35,20,26,2,26,42,61.9,16,29,14,15,25,73,64,1
4596,60,37,24,28,8,25,43,58.1,18,27,5,22,20,80,25,0
4597,38,19,23,14,1,24,36,66.7,12,28,19,9,24,62,81,1
4598,41,24,23,14,4,17,22,77.3,5,11,7,4,13,54,43,1
4599,55,35,16,32,7,28,58,48.3,30,17,1,16,17,72,25,0
4600,26,18,8,12,6,9,22,40.9,13,8,1,7,25,51,13,1
4601,0,0,0,0,0,0,1,0.0,1,0,0,0,0,0,3,1
4602,44,22,19,18,7,22,42,52.4,20,14,2,12,7,51,35,0
4603,28,19,8,16,4,9,24,37.5,15,13,2,11,4,32,8,0
4604,25,17,12,5,8,15,33,45.5,18,19,1,18,12,37,15,0
4605,20,13,7,11,2,15,24,62.5,9,16,3,13,9,29,27,0
4606,10,7,2,6,2,1,8,12.5,7,8,0,8,6,16,2,0
4607,18,14,1,9,8,5,16,31.3,11,15,1,14,2,20,6,0
4608,33,22,9,15,9,14,26,53.8,12,11,2,9,19,52,4,2
4609,0,0,0,0,0,0,0,0.0,0,0,0,0,0,0,5,1
4610,28,18,15,12,1,13,20,65.0,7,11,7,4,9,37,23,0
4611,13,5,7,5,1,5,9,55.6,4,5,0,5,6,19,8,0
4612,0,0,0,0,0,0,0,0.0,0,0,0,0,0,0,0,0
4613,1,0,0,1,0,0,1,0.0,1,2,2,0,1,2,4,0
4614,4,2,3,1,0,2,3,66.7,1,1,0,1,0,4,2,0
4615,2,2,0,2,0,1,1,100.0,0,0,0,0,0,2,0,0
4616,4,3,0,4,0,2,2,100.0,0,0,0,0,2,6,0,0
4617,1,1,1,0,0,1,2,50.0,1,1,0,1,0,1,1,0
4618,0,0,0,0,0,0,0,0.0,0,0,0,0,0,0,0,0
4619,0,0,0,0,0,0,0,0.0,0,0,0,0,0,0,0,0
4620,0,0,0,0,0,0,0,0.0,0,1,0,1,0,0,0,0
4621,0,0,0,0,0,0,0,0.0,0,0,0,0,0,0,0,0
4622,73,43,32,32,9,49,84,58.3,35,41,8,33,18,91,43,0
4623,50,36,33,16,1,30,58,51.7,28,30,14,16,53,103,109,3
4624,64,43,34,24,6,33,42,78.6,9,47,24,23,23,87,91,0
4625,23,12,10,7,6,10,32,31.3,22,11,0,11,7,30,4,0
4626,39,27,8,21,10,15,34,44.1,19,24,0,24,16,55,8,0
4627,1,1,1,0,0,1,2,50.0,1,0,0,0,1,2,10,3
4628,65,53,21,26,18,29,63,46.0,34,49,12,37,35,100,38,0
4629,20,12,9,8,3,7,32,21.9,25,26,0,26,8,28,3,1
4630,32,22,10,18,4,17,35,48.6,18,15,2,13,8,40,7,1
4631,52,35,23,19,10,30,44,68.2,14,24,4,20,32,84,28,1
4632,79,45,26,43,10,39,75,52.0,36,36,5,31,49,128,13,0
4633,53,33,33,11,9,37,67,55.2,30,20,5,15,17,70,40,0
4634,11,7,2,5,4,3,9,33.3,6,8,0,8,1,12,7,0
4635,12,3,2,8,2,4,11,36.4,7,15,2,13,5,17,2,0
4636,11,5,2,5,4,7,12,58.3,5,6,0,6,0,11,2,0
4637,12,8,4,4,4,3,5,60.0,2,8,2,6,0,12,6,0
4638,18,10,7,9,2,8,12,66.7,4,8,3,5,10,28,9,0
4639,12,7,3,4,5,8,14,57.1,6,7,0,7,1,13,0,0
4640,12,9,4,3,5,5,8,62.5,3,10,4,6,8,20,18,0
4641,0,0,0,0,0,0,0,0.0,0,0,0,0,0,0,2,0
4642,2,1,0,0,2,0,0,0.0,0,3,0,3,0,2,1,0
4643,9,4,7,2,0,6,8,75.0,2,1,0,1,1,10,9,1
4644,5,4,1,4,0,1,3,33.3,2,1,0,1,2,7,3,0
4645,0,0,0,0,0,0,1,0.0,1,3,1,2,0,0,1,0
4646,1,0,0,1,0,1,3,33.3,2,0,0,0,1,2,0,0
4647,0,0,0,0,0,0,0,0.0,0,0,0,0,0,0,0,0
4648,0,0,0,0,0,0,2,0.0,2,2,0,2,0,0,3,0
4649,0,0,0,0,0,0,0,0.0,0,2,1,1,1,1,0,0
4650,0,0,0,0,0,0,0,0.0,0,0,0,0,0,0,0,0
4651,0,0,0,0,0,0,0,0.0,0,0,0,0,0,0,0,0
4652,0,0,0,0,0,0,1,0.0,1,0,0,0,0,0,0,0
4653,0,0,0,0,0,0,0,0.0,0,0,0,0,1,1,0,0
4654,1,0,1,0,0,0,0,0.0,0,0,0,0,0,1,0,0
4655,0,0,0,0,0,0,0,0.0,0,0,0,0,0,0,0,0
4656,0,0,0,0,0,0,0,0.0,0,0,0,0,0,0,17,2
4657,26,18,8,12,6,9,33,27.3,24,30,2,28,22,48,16,0
4658,36,20,11,21,4,15,35,42.9,20,32,8,24,23,59,28,0
4659,33,20,13,16,4,22,44,50.0,22,19,4,15,13,46,18,1
4660,19,11,2,9,8,7,13,53.8,6,15,1,14,3,22,8,0
4661,25,18,11,8,6,11,28,39.3,17,22,2,20,15,40,18,0
4662,40,23,16,23,1,21,37,56.8,16,21,3,18,14,54,42,0
4663,28,16,16,12,0,16,30,53.3,14,13,8,5,19,47,50,1
4664,40,31,9,15,16,16,30,53.3,14,14,1,13,2,42,4,1
4665,42,28,13,21,8,22,38,57.9,16,24,3,21,10,52,11,0
4666,41,27,16,19,6,19,34,55.9,15,28,5,23,18,59,24,0
4667,24,15,8,9,7,8,24,33.3,16,14,3,11,7,31,21,0
4668,5,3,1,4,0,0,2,0.0,2,12,8,4,12,17,37,0
4669,11,6,9,1,1,9,15,60.0,6,10,6,4,7,18,28,0
4670,15,7,8,6,1,10,17,58.8,7,5,2,3,9,24,31,0
4671,5,4,2,2,1,4,5,80.0,1,11,7,4,2,7,31,1
4672,19,13,12,5,2,15,23,65.2,8,5,0,5,7,26,7,0
4673,11,7,2,5,4,3,8,37.5,5,5,1,4,2,13,2,0
4674,2,1,1,0,1,1,6,16.7,5,2,0,2,0,2,0,0
4675,6,5,3,3,0,4,11,36.4,7,1,0,1,4,10,5,0
4676,9,4,5,4,0,5,7,71.4,2,1,1,0,4,13,9,0
4677,3,2,1,2,0,2,3,66.7,1,4,2,2,4,7,4,0
4678,10,6,6,3,1,6,7,85.7,1,3,0,3,4,14,7,0
4679,17,13,5,11,1,11,13,84.6,2,4,1,3,6,23,4,0
4680,3,2,2,1,0,3,5,60.0,2,5,3,2,2,5,2,0
4681,2,2,1,1,0,1,6,16.7,5,0,0,0,1,3,4,0
4682,7,4,6,1,0,4,8,50.0,4,3,0,3,0,7,4,0
4683,4,2,0,4,0,1,3,33.3,2,5,0,5,0,4,2,0
4684,1,0,1,0,0,0,3,0.0,3,1,0,1,3,4,3,0
4685,0,0,0,0,0,0,0,0.0,0,0,0,0,1,1,0,0
4686,0,0,0,0,0,0,3,0.0,3,0,0,0,0,0,0,0
4687,0,0,0,0,0,0,0,0.0,0,0,0,0,0,0,1,0
4688,1,1,1,0,0,0,2,0.0,2,1,0,1,0,1,20,2
4689,61,33,36,23,2,23,42,54.8,19,25,5,20,22,83,55,0
4690,23,13,9,11,3,5,37,13.5,32,23,2,21,11,34,12,0
4691,41,27,18,17,6,31,49,63.3,18,22,6,16,26,67,62,1
4692,68,42,24,42,2,31,69,44.9,38,27,8,19,30,98,28,1
4693,11,6,4,2,5,1,10,10.0,9,16,1,15,8,19,14,0
4694,40,27,11,24,5,18,42,42.9,24,33,3,30,9,49,16,3
4695,27,19,7,14,6,15,45,33.3,30,17,1,16,23,50,15,0
4696,8,6,1,4,3,4,8,50.0,4,6,1,5,6,14,12,0
4697,22,12,6,12,4,8,27,29.6,19,13,1,12,6,28,4,0
4698,34,18,20,13,1,21,31,67.7,10,18,9,9,35,69,79,1
4699,27,17,18,9,0,17,24,70.8,7,17,10,7,38,65,46,3
4700,8,3,6,2,0,3,8,37.5,5,18,13,5,20,28,70,0
4701,13,9,8,5,0,8,12,66.7,4,13,7,6,16,29,72,2
4702,41,22,21,19,1,22,37,59.5,15,22,4,18,17,58,29,1
4703,6,4,4,1,1,2,8,25.0,6,8,0,8,3,9,6,1
4704,18,8,10,6,2,8,17,47.1,9,7,3,4,6,24,20,0
4705,20,14,9,10,1,9,14,64.3,5,4,2,2,14,34,8,1
4706,16,11,3,10,3,9,20,45.0,11,10,0,10,4,20,3,0
4707,12,8,2,4,6,8,15,53.3,7,12,1,11,1,13,5,0
4708,7,3,2,3,2,3,5,60.0,2,6,3,3,6,13,7,0
4709,6,6,1,2,3,3,4,75.0,1,3,1,2,2,8,4,0
4710,7,4,4,3,0,1,4,25.0,3,3,1,2,5,12,5,0
4711,1,0,0,1,0,1,4,25.0,3,4,1,3,1,2,1,0
4712,0,0,0,0,0,0,2,0.0,2,0,0,0,0,0,0,0
4713,35,18,12,14,9,11,43,25.6,32,34,2,32,17,52,28,0
4714,48,31,16,26,6,28,47,59.6,19,21,3,18,23,71,10,0
4715,52,39,29,22,1,38,68,55.9,30,35,11,24,26,78,115,0
4716,33,17,16,14,3,19,34,55.9,15,36,17,19,21,54,88,0
4717,45,30,14,24,7,22,46,47.8,24,17,1,16,27,72,13,0
4718,37,23,21,10,6,19,32,59.4,13,35,4,31,17,54,32,1
4719,0,0,0,0,0,0,1,0.0,1,0,0,0,0,0,9,1
4720,22,14,20,2,0,22,28,78.6,6,25,11,14,36,58,108,0
4721,25,17,16,7,2,14,27,51.9,13,15,3,12,14,39,27,0
4722,19,10,3,12,4,8,13,61.5,5,20,1,19,5,24,17,0
4723,50,33,37,12,1,27,50,54.0,23,23,13,10,22,72,78,3
4724,21,9,5,10,6,10,29,34.5,19,19,1,18,9,30,7,1
4725,16,11,8,5,3,8,12,66.7,4,5,0,5,4,20,15,0
4726,10,6,3,7,0,5,26,19.2,21,12,0,12,5,15,5,0
4727,30,19,17,11,2,21,31,67.7,10,10,2,8,14,44,25,1
4728,8,6,3,3,2,3,7,42.9,4,6,0,6,11,19,11,0
4729,0,0,0,0,0,0,1,0.0,1,0,0,0,0,0,6,0
4730,9,4,3,5,1,6,10,60.0,4,9,1,8,4,13,7,0
4731,4,4,1,3,0,0,1,0.0,1,4,1,3,2,6,3,0
4732,4,3,1,1,2,3,4,75.0,1,8,5,3,8,12,16,0
4733,10,8,6,3,1,6,13,46.2,7,8,0,8,0,10,1,0
4734,3,3,0,3,0,1,2,50.0,1,4,1,3,0,3,8,0
4735,10,5,5,5,0,6,18,33.3,12,6,1,5,6,16,7,0
4736,10,8,3,4,3,5,11,45.5,6,11,0,11,6,16,4,0
4737,4,2,2,2,0,1,1,100.0,0,2,0,2,0,4,3,0
4738,0,0,0,0,0,0,0,0.0,0,0,0,0,0,0,0,0
4739,0,0,0,0,0,0,0,0.0,0,1,0,1,0,0,0,0
4740,81,54,38,33,10,29,75,38.7,46,57,5,52,59,140,52,0
4741,1,1,1,0,0,0,0,0.0,0,0,0,0,0,1,16,2
4742,44,35,35,8,1,24,34,70.6,10,34,28,6,22,66,150,0
4743,27,13,10,15,2,8,38,21.1,30,22,5,17,17,44,19,1
4744,44,32,7,25,12,9,29,31.0,20,24,2,22,7,51,5,0
4745,37,25,13,14,10,15,28,53.6,13,23,2,21,14,51,16,0
4746,36,20,28,8,0,18,31,58.1,13,39,27,12,28,64,142,0
4747,45,30,27,11,7,25,35,71.4,10,13,2,11,29,74,60,1
4748,35,22,26,7,2,21,29,72.4,8,21,5,16,39,74,81,0
4749,10,6,7,3,0,6,17,35.3,11,12,1,11,16,26,10,0
4750,8,6,2,4,2,4,10,40.0,6,11,3,8,6,14,24,0
4751,6,4,2,3,1,1,9,11.1,8,17,0,17,11,17,18,0
4752,28,19,16,10,2,16,31,51.6,15,17,3,14,15,43,32,0
4753,20,17,12,8,0,14,17,82.4,3,16,10,6,12,32,61,2
4754,20,12,10,6,4,10,14,71.4,4,10,3,7,8,28,24,0
4755,20,11,7,10,3,7,19,36.8,12,22,3,19,4,24,10,0
4756,15,10,6,7,2,10,17,58.8,7,6,0,6,6,21,15,0
4757,6,3,1,4,1,0,1,0.0,1,4,0,4,0,6,3,0
4758,6,1,1,4,1,2,8,25.0,6,8,4,4,7,13,14,0
4759,4,2,2,0,2,1,10,10.0,9,7,4,3,4,8,2,0
4760,0,0,0,0,0,0,0,0.0,0,0,0,0,0,0,1,0
4761,13,8,8,5,0,8,20,40.0,12,8,1,7,5,18,9,0
4762,2,1,1,1,0,1,6,16.7,5,0,0,0,1,3,3,0
4763,3,2,3,0,0,2,4,50.0,2,5,5,0,1,4,19,1
4764,13,7,4,5,4,6,10,60.0,4,3,1,2,6,19,11,0
4765,4,2,1,2,1,3,5,60.0,2,2,0,2,1,5,0,0
4766,4,2,1,2,1,2,3,66.7,1,1,0,1,0,4,0,0
4767,0,0,0,0,0,0,0,0.0,0,0,0,0,0,0,0,0
4768,0,0,0,0,0,0,0,0.0,0,0,0,0,0,0,0,0
4769,20,15,4,7,9,9,31,29.0,22,9,1,8,6,26,12,0
4770,69,41,24,31,14,38,73,52.1,35,42,3,39,27,96,17,0
4771,22,17,5,10,7,9,39,23.1,30,29,3,26,12,34,8,0
4772,3,2,3,0,0,3,6,50.0,3,0,0,0,1,4,23,3
4773,47,28,22,21,4,28,63,44.4,35,40,9,31,34,81,22,3
4774,28,20,24,4,0,14,35,40.0,21,35,19,16,31,59,137,1
4775,22,14,5,8,9,2,13,15.4,11,23,3,20,5,27,16,0
4776,61,37,37,20,4,42,68,61.8,26,36,9,27,34,95,72,0
4777,53,29,25,24,4,34,48,70.8,14,28,6,22,17,70,46,0
4778,29,20,8,18,3,18,45,40.0,27,19,1,18,11,40,8,0
4779,10,6,6,2,2,7,17,41.2,10,10,7,3,16,26,68,0
4780,26,17,12,11,3,14,27,51.9,13,17,7,10,11,37,39,0
4781,49,30,24,21,4,29,51,56.9,22,12,4,8,13,62,33,0
4782,15,12,9,6,0,7,11,63.6,4,12,8,4,9,24,35,0
4783,17,14,11,6,0,7,24,29.2,17,15,0,15,6,23,8,0
4784,12,8,8,2,2,6,7,85.7,1,6,5,1,9,21,31,0
4785,6,4,3,3,0,5,8,62.5,3,2,2,0,6,12,26,0
4786,9,5,5,3,1,3,4,75.0,1,5,3,2,2,11,10,0
4787,8,6,4,3,1,6,13,46.2,7,5,1,4,5,13,6,1
4788,0,0,0,0,0,0,0,0.0,0,0,0,0,0,0,0,0
4789,0,0,0,0,0,0,2,0.0,2,1,0,1,0,0,1,0
4790,4,2,2,2,0,0,2,0.0,2,4,0,4,3,7,2,0
4791,1,0,0,0,1,0,0,0.0,0,2,0,2,0,1,9,0
4792,4,4,3,0,1,1,3,33.3,2,2,0,2,2,6,1,0
4793,1,1,1,0,0,1,2,50.0,1,0,0,0,0,1,2,0
4794,6,2,5,1,0,4,5,80.0,1,1,0,1,1,7,1,0
4795,5,4,3,1,1,3,6,50.0,3,3,0,3,1,6,1,0
4796,1,1,1,0,0,1,1,100.0,0,1,0,1,0,1,1,0
4797,0,0,0,0,0,0,0,0.0,0,0,0,0,0,0,1,0
4798,1,0,1,0,0,0,0,0.0,0,2,1,1,0,1,1,0
4799,1,0,0,0,1,0,0,0.0,0,0,0,0,0,1,0,0
4800,1,0,1,0,0,1,3,33.3,2,1,0,1,1,2,28,2
4801,55,35,29,13,13,29,41,70.7,12,43,7,36,33,88,79,1
4802,76,48,34,32,10,28,60,46.7,32,32,2,30,27,103,25,0
4803,10,7,1,6,3,2,9,22.2,7,4,2,2,1,11,21,0
4804,51,39,24,24,3,21,31,67.7,10,27,4,23,47,98,47,1
4805,37,22,6,22,9,12,40,30.0,28,16,5,11,12,49,31,0
4806,31,18,13,15,3,12,31,38.7,19,43,4,39,13,44,10,0
4807,61,42,39,20,2,27,59,45.8,32,18,1,17,19,80,38,0
4808,23,14,17,6,0,15,29,51.7,14,26,13,13,13,36,84,0
4809,22,15,16,6,0,11,21,52.4,10,16,12,4,24,46,80,1
4810,20,15,14,6,0,14,22,63.6,8,25,19,6,23,43,75,0
4811,20,14,12,5,3,16,30,53.3,14,13,3,10,10,30,16,0
4812,31,21,24,5,2,20,31,64.5,11,33,21,12,25,56,66,0
4813,21,18,15,4,2,17,24,70.8,7,12,2,10,11,32,31,0
4814,14,9,4,8,2,8,17,47.1,9,11,0,11,7,21,11,0
4815,7,4,1,4,2,2,10,20.0,8,6,2,4,1,8,1,0
4816,10,3,5,3,2,3,6,50.0,3,7,2,5,7,17,7,0
4817,3,1,0,3,0,1,3,33.3,2,3,1,2,1,4,3,0
4818,17,12,11,6,0,10,20,50.0,10,8,2,6,9,26,16,1
4819,6,3,3,2,1,3,9,33.3,6,2,0,2,3,9,0,0
4820,12,8,7,4,1,7,11,63.6,4,9,4,5,6,18,2,0
4821,5,3,4,0,1,3,12,25.0,9,4,0,4,3,8,5,0
4822,3,3,1,0,2,2,2,100.0,0,5,0,5,0,3,3,0
4823,3,3,3,0,0,2,4,50.0,2,4,1,3,1,4,3,0
4824,4,0,0,2,2,2,5,40.0,3,4,0,4,2,6,4,0
4825,0,0,0,0,0,0,0,0.0,0,0,0,0,0,0,0,0
4826,4,2,1,1,2,1,3,33.3,2,0,0,0,0,4,1,0
4827,53,32,35,13,5,40,74,54.1,34,35,6,29,37,90,70,0
4828,1,0,1,0,0,1,3,33.3,2,0,0,0,0,1,6,1
4829,41,29,26,14,1,32,49,65.3,17,40,22,18,28,69,127,2
4830,46,36,27,14,5,26,45,57.8,19,28,6,22,43,89,69,0
4831,50,32,26,18,6,31,62,50.0,31,37,9,28,21,71,44,0
4832,28,20,20,7,1,15,23,65.2,8,33,19,14,17,45,113,0
4833,20,14,6,10,4,7,21,33.3,14,12,1,11,4,24,11,0
4834,9,7,1,3,5,1,14,7.1,13,13,2,11,3,12,12,0
4835,25,13,4,19,2,13,33,39.4,20,18,1,17,17,42,9,1
4836,14,8,1,7,6,3,13,23.1,10,7,1,6,1,15,7,0
4837,12,7,8,4,0,8,20,40.0,12,19,11,8,14,26,55,1
4838,32,24,17,15,0,13,28,46.4,15,17,2,15,19,51,18,0
4839,23,14,17,5,1,16,26,61.5,10,14,6,8,18,41,79,1
4840,21,12,4,13,4,7,20,35.0,13,12,1,11,9,30,7,0
4841,8,5,7,1,0,5,9,55.6,4,13,6,7,10,18,29,0
4842,8,7,4,3,1,4,14,28.6,10,15,1,14,5,13,4,0
4843,29,19,12,16,1,15,31,48.4,16,7,1,6,15,44,6,0
4844,7,3,6,1,0,3,4,75.0,1,5,1,4,2,9,15,0
4845,9,6,4,4,1,6,14,42.9,8,7,1,6,4,13,13,0
4846,7,5,4,1,2,5,9,55.6,4,4,0,4,4,11,4,0
4847,12,8,4,5,3,4,12,33.3,8,3,1,2,5,17,8,0
4848,10,6,4,3,3,3,8,37.5,5,6,0,6,0,10,2,0
4849,5,3,3,1,1,0,1,0.0,1,7,0,7,4,9,0,0
4850,19,16,4,7,8,9,16,56.3,7,9,0,9,1,20,2,0
4851,0,0,0,0,0,0,1,0.0,1,0,0,0,0,0,0,0
4852,4,2,0,2,2,0,0,0.0,0,2,0,2,0,4,1,0
4853,1,1,0,1,0,1,2,50.0,1,0,0,0,1,2,1,0
4854,4,1,3,1,0,1,6,16.7,5,3,1,2,3,7,0,0
4855,0,0,0,0,0,0,0,0.0,0,0,0,0,0,0,0,0
4856,0,0,0,0,0,0,1,0.0,1,0,0,0,0,0,0,0
4857,0,0,0,0,0,0,0,0.0,0,0,0,0,0,0,0,0
4858,0,0,0,0,0,0,0,0.0,0,0,0,0,0,0,0,0
4859,36,21,29,7,0,22,35,62.9,13,45,32,13,39,75,231,1
4860,0,0,0,0,0,0,1,0.0,1,0,0,0,0,0,21,2
4861,78,45,33,44,1,29,82,35.4,53,48,17,31,40,118,128,1
4862,40,26,20,12,8,13,32,40.6,19,19,0,19,22,62,20,0
4863,55,34,34,19,2,31,60,51.7,29,32,7,25,50,105,83,0
4864,44,34,24,17,3,19,43,44.2,24,40,8,32,27,71,42,0
4865,15,9,1,11,3,8,27,29.6,19,24,5,19,7,22,27,0
4866,41,28,19,17,5,17,41,41.5,24,38,6,32,21,62,32,0
4867,36,26,21,13,2,18,25,72.0,7,31,13,18,26,62,87,0
4868,11,4,5,6,0,6,14,42.9,8,42,33,9,15,26,103,0
4869,25,10,14,8,3,13,37,35.1,24,27,9,18,22,47,19,0
4870,49,25,27,20,2,21,33,63.6,12,35,14,21,11,60,17,0
4871,8,6,7,0,1,6,7,85.7,1,4,4,0,12,20,64,0
4872,18,13,12,5,1,12,23,52.2,11,13,3,10,18,36,43,0
4873,9,5,6,2,1,6,17,35.3,11,11,2,9,1,10,12,0
4874,12,9,5,4,3,6,11,54.5,5,8,4,4,4,16,3,0
4875,3,2,2,1,0,3,5,60.0,2,7,1,6,0,3,2,0
4876,10,7,2,4,4,2,4,50.0,2,12,3,9,4,14,17,0
4877,7,2,3,3,1,4,6,66.7,2,9,2,7,2,9,8,0
4878,3,3,0,1,2,1,3,33.3,2,9,3,6,1,4,4,0
4879,7,4,5,2,0,4,5,80.0,1,10,8,2,7,14,37,0
4880,0,0,0,0,0,0,0,0.0,0,0,0,0,0,0,1,0
4881,5,3,2,3,0,1,5,20.0,4,6,1,5,3,8,2,0
4882,3,2,3,0,0,2,2,100.0,0,2,0,2,0,3,0,0
4883,0,0,0,0,0,0,1,0.0,1,0,0,0,0,0,1,0
4884,95,60,41,43,11,55,104,52.9,49,88,12,76,40,135,92,3
4885,68,44,50,18,0,34,47,72.3,13,58,40,18,45,113,167,1
4886,36,24,25,7,4,22,52,42.3,30,35,5,30,17,53,35,0
4887,34,22,8,21,5,19,34,55.9,15,22,4,18,30,64,20,3
4888,0,0,0,0,0,0,0,0.0,0,0,0,0,1,1,16,3
4889,30,20,18,11,1,16,26,61.5,10,24,11,13,23,53,78,0
4890,11,5,4,2,5,8,17,47.1,9,13,1,12,13,24,15,0
4891,12,9,4,6,2,3,7,42.9,4,11,3,8,5,17,16,0
4892,32,20,17,14,1,20,32,62.5,12,22,12,10,22,54,79,1
4893,22,12,3,15,4,10,27,37.0,17,8,0,8,4,26,8,0
4894,22,10,11,10,1,11,16,68.8,5,15,8,7,9,31,54,0
4895,38,25,13,18,7,20,44,45.5,24,8,3,5,9,47,9,0
4896,2,2,0,2,0,1,8,12.5,7,3,2,1,0,2,17,0
4897,18,8,14,4,0,12,21,57.1,9,9,2,7,26,44,44,0
4898,10,4,3,6,1,0,7,0.0,7,9,0,9,3,13,9,0
4899,17,10,9,7,1,9,21,42.9,12,14,2,12,4,21,5,0
4900,6,6,2,3,1,5,12,41.7,7,3,1,2,4,10,13,0
4901,2,1,2,0,0,2,2,100.0,0,0,0,0,0,2,2,1
4902,18,8,6,9,3,5,15,33.3,10,4,1,3,8,26,1,0
4903,10,7,1,8,1,4,10,40.0,6,9,0,9,2,12,5,0
4904,20,13,9,9,2,10,18,55.6,8,15,3,12,6,26,18,0
4905,3,1,2,0,1,2,7,28.6,5,3,0,3,2,5,7,0
4906,12,8,3,8,1,5,17,29.4,12,9,0,9,4,16,7,0
4907,0,0,0,0,0,0,4,0.0,4,1,1,0,1,1,1,0
4908,13,4,4,7,2,4,10,40.0,6,6,0,6,5,18,7,1
4909,4,2,2,2,0,3,8,37.5,5,3,1,2,2,6,6,2
4910,5,4,2,3,0,2,4,50.0,2,7,3,4,3,8,5,0
4911,0,0,0,0,0,0,0,0.0,0,0,0,0,0,0,2,0
4912,0,0,0,0,0,0,1,0.0,1,0,0,0,0,0,0,0
4913,0,0,0,0,0,0,2,0.0,2,1,1,0,1,1,8,0
4914,0,0,0,0,0,0,1,0.0,1,2,2,0,0,0,4,0
4915,1,0,0,0,1,1,3,33.3,2,0,0,0,0,1,3,0
4916,0,0,0,0,0,0,0,0.0,0,1,1,0,0,0,2,0
4917,0,0,0,0,0,0,0,0.0,0,0,0,0,0,0,14,2
4918,34,24,25,6,3,26,38,68.4,12,42,30,12,26,60,130,0
4919,18,11,15,3,0,9,21,42.9,12,33,19,14,35,53,117,1
4920,46,26,16,25,5,28,68,41.2,40,51,4,47,28,74,6,2
4921,31,22,11,11,9,21,29,72.4,8,28,2,26,21,52,16,1
4922,21,15,9,12,0,10,20,50.0,10,16,0,16,16,37,13,0
4923,48,30,28,15,5,33,46,71.7,13,21,8,13,28,76,65,1
4924,26,15,7,15,4,9,15,60.0,6,23,4,19,11,37,8,0
4925,50,34,34,9,7,20,37,54.1,17,21,6,15,30,80,56,2
4926,59,36,28,21,10,32,47,68.1,15,33,15,18,27,86,52,1
4927,45,23,17,26,2,22,57,38.6,35,25,0,25,18,63,16,1
4928,46,35,23,15,8,22,44,50.0,22,15,4,11,15,61,17,0
4929,25,17,13,10,2,14,24,58.3,10,6,1,5,15,40,57,1
4930,9,4,0,3,6,2,5,40.0,3,6,0,6,0,9,4,0
4931,1,1,0,0,1,0,3,0.0,3,2,0,2,0,1,5,0
4932,13,8,3,9,1,5,17,29.4,12,14,2,12,3,16,8,1
4933,5,4,2,1,2,2,5,40.0,3,3,0,3,2,7,4,0
4934,18,11,11,7,0,8,11,72.7,3,3,0,3,7,25,26,0
4935,8,4,8,0,0,5,5,100.0,0,7,3,4,1,9,22,0
4936,4,3,1,2,1,3,12,25.0,9,8,0,8,3,7,5,0
4937,7,2,4,3,0,5,7,71.4,2,3,2,1,2,9,8,0
4938,4,3,2,1,1,3,3,100.0,0,3,1,2,4,8,12,0
4939,6,5,1,4,1,4,9,44.4,5,4,1,3,4,10,8,0
4940,0,0,0,0,0,0,0,0.0,0,0,0,0,0,0,0,1
4941,0,0,0,0,0,0,1,0.0,1,0,0,0,1,1,2,0
4942,2,2,0,1,1,0,2,0.0,2,1,0,1,1,3,1,0
4943,8,4,2,6,0,4,6,66.7,2,3,0,3,2,10,3,0
4944,2,0,1,0,1,1,4,25.0,3,0,0,0,2,4,0,0
4945,1,1,0,0,1,0,1,0.0,1,1,0,1,1,2,0,0
4946,3,1,0,1,2,1,1,100.0,0,1,0,1,0,3,1,0
4947,0,0,0,0,0,0,1,0.0,1,0,0,0,0,0,0,0
4948,18,9,5,10,3,5,18,27.8,13,18,1,17,7,25,3,0
4949,39,21,24,14,1,23,40,57.5,17,38,24,14,23,62,107,2
4950,34,22,17,14,3,21,48,43.8,27,23,0,23,27,61,67,1
4951,47,30,21,19,7,19,49,38.8,30,39,6,33,25,72,53,1
4952,79,46,28,40,11,39,78,50.0,39,44,6,38,25,104,16,2
4953,1,1,1,0,0,1,2,50.0,1,0,0,0,0,1,8,4
4954,39,25,5,26,8,11,29,37.9,18,20,2,18,11,50,13,0
4955,11,7,11,0,0,7,12,58.3,5,21,15,6,23,34,96,0
4956,31,20,10,13,8,13,30,43.3,17,16,2,14,0,31,11,0
4957,19,15,10,9,0,8,24,33.3,16,21,14,7,21,40,55,2
4958,14,9,7,5,2,4,18,22.2,14,6,0,6,4,18,5,2
4959,30,25,9,18,3,14,24,58.3,10,11,7,4,15,45,19,2
4960,10,7,1,8,1,2,9,22.2,7,14,4,10,3,13,15,0
4961,26,18,17,7,2,14,25,56.0,11,16,9,7,16,42,53,0
4962,18,9,9,8,1,8,21,38.1,13,7,2,5,10,28,25,0
4963,3,2,3,0,0,3,3,100.0,0,0,0,0,0,3,9,0
4964,15,7,9,5,1,8,11,72.7,3,11,9,2,21,36,40,1
4965,34,24,22,10,2,23,29,79.3,6,24,5,19,8,42,29,0
4966,8,5,6,2,0,4,9,44.4,5,3,2,1,2,10,9,0
4967,14,5,11,2,1,7,14,50.0,7,5,1,4,11,25,6,0
4968,5,4,3,2,0,1,3,33.3,2,4,3,1,7,12,16,0
4969,13,10,6,4,3,7,10,70.0,3,5,0,5,1,14,3,0
4970,10,4,5,3,2,6,10,60.0,4,4,0,4,2,12,6,0
4971,5,3,3,1,1,5,7,71.4,2,2,0,2,1,6,6,0
4972,4,2,3,1,0,4,6,66.7,2,1,0,1,1,5,2,0
4973,9,4,2,6,1,4,6,66.7,2,2,1,1,3,12,3,0
4974,2,1,1,1,0,0,2,0.0,2,4,0,4,1,3,2,0
4975,0,0,0,0,0,0,1,0.0,1,0,0,0,0,0,9,1
4976,0,0,0,0,0,0,1,0.0,1,0,0,0,0,0,0,0
4977,0,0,0,0,0,0,0,0.0,0,0,0,0,0,0,1,0
4978,0,0,0,0,0,0,0,0.0,0,0,0,0,1,1,0,0
4979,60,40,23,30,7,32,64,50.0,32,36,8,28,19,79,19,0
4980,35,23,12,14,9,11,23,47.8,12,23,2,21,12,47,17,0
4981,53,36,29,20,4,32,41,78.0,9,35,19,16,40,93,146,2
4982,2,2,2,0,0,2,4,50.0,2,1,0,1,0,2,18,0
4983,25,18,12,10,3,18,29,62.1,11,27,7,20,20,45,53,0
4984,44,30,13,27,4,19,46,41.3,27,16,4,12,24,68,20,0
4985,34,24,18,16,0,22,30,73.3,8,21,13,8,18,52,45,1
4986,40,24,24,13,3,25,51,49.0,26,27,2,25,24,64,45,0
4987,14,8,3,7,4,7,18,38.9,11,13,0,13,4,18,6,0
4988,3,3,0,2,1,1,2,50.0,1,2,0,2,1,4,13,0
4989,27,19,23,4,0,14,18,77.8,4,17,10,7,13,40,43,1
4990,19,10,6,9,4,9,24,37.5,15,22,1,21,4,23,9,0
4991,9,4,2,4,3,2,4,50.0,2,10,1,9,2,11,15,0
4992,20,12,13,6,1,12,20,60.0,8,20,12,8,21,41,47,1
4993,14,8,7,6,1,4,11,36.4,7,12,1,11,8,22,36,0
4994,13,9,10,2,1,7,12,58.3,5,14,10,4,15,28,42,1
4995,24,18,9,13,2,18,30,60.0,12,11,1,10,10,34,21,0
4996,16,9,5,8,3,10,25,40.0,15,15,2,13,3,19,4,0
4997,36,23,15,14,7,21,39,53.8,18,11,2,9,4,40,5,0
4998,12,7,5,7,0,7,24,29.2,17,6,0,6,4,16,9,0
4999,8,5,1,2,5,2,4,50.0,2,10,1,9,5,13,6,0
5000,20,15,15,5,0,16,22,72.7,6,5,1,4,4,24,9,0
5001,12,11,4,5,3,10,12,83.3,2,12,7,5,7,19,20,1
5002,9,4,4,5,0,3,10,30.0,7,4,2,2,6,15,7,0
5003,6,5,3,3,0,3,7,42.9,4,6,4,2,3,9,19,0
5004,6,4,3,3,0,2,3,66.7,1,3,1,2,4,10,15,0
5005,0,0,0,0,0,0,0,0.0,0,1,0,1,0,0,5,0
5006,2,2,1,1,0,0,1,0.0,1,2,0,2,1,3,1,0
5007,0,0,0,0,0,0,0,0.0,0,0,0,0,0,0,1,0
5008,2,2,2,0,0,2,3,66.7,1,2,0,2,0,2,2,0
5009,4,3,0,2,2,0,1,0.0,1,0,0,0,0,4,2,0
5010,5,3,1,4,0,3,4,75.0,1,6,4,2,4,9,6,1
5011,0,0,0,0,0,0,0,0.0,0,0,0,0,1,1,2,0
5012,0,0,0,0,0,0,0,0.0,0,0,0,0,0,0,1,1
5013,1,1,1,0,0,1,4,25.0,3,0,0,0,0,1,20,2
5014,21,9,14,5,2,9,31,29.0,22,8,1,7,16,37,19,0
5015,16,10,0,12,4,5,16,31.3,11,12,1,11,4,20,34,0
5016,46,26,33,13,0,26,40,65.0,14,59,32,27,34,80,110,3
5017,74,39,41,30,3,39,68,57.4,29,30,8,22,22,96,26,1
5018,29,22,11,17,1,14,23,60.9,9,21,2,19,20,49,34,0
5019,48,30,14,29,5,22,48,45.8,26,22,8,14,21,69,37,2
5020,30,15,5,18,7,12,38,31.6,26,11,0,11,15,45,15,0
5021,58,33,34,21,3,36,57,63.2,21,27,8,19,24,82,48,1
5022,50,37,26,20,4,21,36,58.3,15,28,6,22,24,74,57,0
5023,23,18,18,3,2,13,21,61.9,8,27,17,10,18,41,98,2
5024,31,22,16,15,0,19,26,73.1,7,21,8,13,18,49,47,1
5025,23,17,14,6,3,12,38,31.6,26,21,1,20,10,33,7,0
5026,23,10,13,9,1,13,23,56.5,10,20,13,7,14,37,69,3
5027,22,16,8,10,4,13,25,52.0,12,7,4,3,3,25,27,0
5028,17,9,13,3,1,10,16,62.5,6,8,3,5,11,28,23,0
5029,4,3,1,3,0,1,4,25.0,3,6,3,3,2,6,4,0
5030,4,4,2,1,1,3,6,50.0,3,4,1,3,4,8,18,0
5031,8,4,4,2,2,2,10,20.0,8,4,0,4,5,13,2,0
5032,11,7,3,7,1,5,12,41.7,7,6,1,5,3,14,5,0
5033,15,11,8,5,2,5,10,50.0,5,5,2,3,5,20,4,0
5034,0,0,0,0,0,0,2,0.0,2,1,0,1,0,0,1,0
5035,0,0,0,0,0,0,0,0.0,0,0,0,0,0,0,0,0
5036,44,27,14,24,6,23,44,52.3,21,12,2,10,8,52,24,2
5037,56,32,43,13,0,28,46,60.9,18,48,25,23,58,114,140,1
5038,35,22,19,10,6,14,39,35.9,25,29,4,25,15,50,31,0
5039,48,29,34,12,2,22,38,57.9,16,32,17,15,50,98,136,0
5040,49,34,39,10,0,27,39,69.2,12,49,33,16,30,79,137,1
5041,51,31,26,21,4,22,47,46.8,25,16,4,12,26,77,43,0
5042,82,54,34,41,7,35,49,71.4,14,30,11,19,20,102,30,1
5043,0,0,0,0,0,0,1,0.0,1,0,0,0,0,0,17,1
5044,22,12,9,8,5,10,21,47.6,11,17,0,17,15,37,16,0
5045,59,38,32,22,5,33,48,68.8,15,27,3,24,27,86,46,1
5046,56,34,31,20,5,30,60,50.0,30,18,7,11,16,72,29,0
5047,55,34,25,24,6,23,50,46.0,27,35,5,30,41,96,45,1
5048,0,0,0,0,0,0,3,0.0,3,0,0,0,0,0,10,1
5049,9,4,1,5,3,2,7,28.6,5,13,1,12,3,12,19,0
5050,29,19,17,9,3,15,19,78.9,4,17,6,11,11,40,28,0
5051,2,2,2,0,0,0,12,0.0,12,10,1,9,2,4,3,0
5052,8,5,0,3,5,2,11,18.2,9,4,0,4,5,13,8,0
5053,11,8,3,8,0,8,14,57.1,6,7,3,4,9,20,11,1
5054,5,3,0,5,0,1,3,33.3,2,9,0,9,1,6,3,0
5055,7,5,2,4,1,4,8,50.0,4,4,1,3,5,12,6,0
5056,14,7,6,7,1,4,15,26.7,11,11,1,10,7,21,10,0
5057,0,0,0,0,0,0,2,0.0,2,3,3,0,1,1,3,0
5058,4,3,1,2,1,2,3,66.7,1,2,1,1,2,6,2,0
5059,4,3,2,1,1,2,6,33.3,4,1,0,1,0,4,6,0
5060,3,3,2,1,0,1,1,100.0,0,4,1,3,1,4,4,0
5061,0,0,0,0,0,0,0,0.0,0,0,0,0,0,0,3,0
5062,4,1,0,4,0,1,2,50.0,1,1,0,1,0,4,0,0
5063,4,3,1,1,2,3,4,75.0,1,2,0,2,1,5,1,0
5064,0,0,0,0,0,0,1,0.0,1,1,0,1,0,0,0,0
5065,0,0,0,0,0,0,0,0.0,0,0,0,0,2,2,0,0
5066,0,0,0,0,0,0,1,0.0,1,0,0,0,0,0,0,0
5067,70,37,32,27,11,34,78,43.6,44,54,12,42,20,90,48,0
5068,9,7,1,5,3,4,9,44.4,5,21,8,13,3,12,17,0
5069,74,50,42,24,8,45,79,57.0,34,33,8,25,41,115,102,1
5070,0,0,0,0,0,0,0,0.0,0,1,0,1,0,0,18,0
5071,33,26,29,4,0,19,35,54.3,16,36,28,8,23,56,124,3
5072,29,19,9,17,3,14,32,43.8,18,17,2,15,10,39,24,0
5073,26,16,12,11,3,11,23,47.8,12,29,6,23,20,46,38,0
5074,33,19,18,8,7,14,30,46.7,16,15,0,15,6,39,3,0
5075,17,8,11,5,1,9,22,40.9,13,18,11,7,21,38,97,1
5076,35,20,18,16,1,18,29,62.1,11,24,7,17,23,58,58,0
5077,15,8,9,5,1,11,14,78.6,3,20,14,6,19,34,62,0
5078,25,10,20,4,1,10,17,58.8,7,14,9,5,14,39,55,1
5079,14,9,6,7,1,4,14,28.6,10,14,2,12,10,24,8,1
5080,27,15,10,14,3,15,26,57.7,11,9,4,5,7,34,21,0
5081,18,9,1,14,3,4,12,33.3,8,11,0,11,4,22,5,0
5082,21,13,9,8,4,6,16,37.5,10,10,0,10,1,22,8,0
5083,4,3,2,2,0,2,6,33.3,4,3,0,3,0,4,7,0
5084,21,12,10,9,2,10,20,50.0,10,13,4,9,6,27,23,0
5085,16,9,10,5,1,7,25,28.0,18,17,3,14,12,28,7,0
5086,3,1,1,1,1,2,9,22.2,7,4,1,3,10,13,5,0
5087,0,0,0,0,0,0,2,0.0,2,0,0,0,0,0,3,1
5088,0,0,0,0,0,0,3,0.0,3,5,2,3,0,0,8,0
5089,8,6,5,2,1,5,8,62.5,3,5,3,2,8,16,15,0
5090,6,5,1,4,1,3,4,75.0,1,2,0,2,2,8,1,0
5091,5,3,1,2,2,4,6,66.7,2,2,0,2,1,6,2,0
5092,4,3,1,1,2,2,7,28.6,5,2,1,1,0,4,1,0
5093,2,1,1,1,0,1,2,50.0,1,0,0,0,2,4,2,0
5094,5,2,3,1,1,3,6,50.0,3,3,1,2,1,6,2,0
5095,1,1,0,1,0,0,1,0.0,1,2,1,1,1,2,0,0
5096,0,0,0,0,0,0,1,0.0,1,0,0,0,1,1,2,0
5097,0,0,0,0,0,0,0,0.0,0,0,0,0,0,0,0,0
5098,11,8,3,5,3,5,17,29.4,12,14,3,11,5,16,18,0
5099,0,0,0,0,0,0,1,0.0,1,0,0,0,0,0,16,2
5100,38,29,7,27,4,20,38,52.6,18,20,2,18,19,57,12,0
5101,19,12,10,7,2,12,41,29.3,29,21,8,13,31,50,44,1
5102,37,25,32,5,0,24,33,72.7,9,22,15,7,27,64,101,0
5103,34,23,23,10,1,22,35,62.9,13,23,8,15,20,54,70,2
5104,23,14,14,7,2,12,20,60.0,8,12,0,12,12,35,11,0
5105,26,14,18,7,1,17,25,68.0,8,17,9,8,9,35,68,1
5106,14,8,11,1,2,9,13,69.2,4,15,3,12,18,32,47,0
5107,13,7,7,3,3,2,11,18.2,9,17,6,11,11,24,13,0
5108,11,8,8,3,0,8,9,88.9,1,17,14,3,4,15,75,3
5109,35,19,20,11,4,18,37,48.6,19,16,5,11,18,53,15,1
5110,45,33,31,12,2,28,42,66.7,14,23,7,16,18,63,53,0
5111,17,5,5,9,3,6,29,20.7,23,25,1,24,9,26,8,0
5112,29,19,15,11,3,16,25,64.0,9,21,3,18,21,50,32,0
5113,22,14,8,12,2,8,18,44.4,10,9,2,7,18,40,27,1
5114,9,5,3,6,0,6,11,54.5,5,7,0,7,7,16,23,0
5115,10,3,4,4,2,3,14,21.4,11,18,0,18,6,16,17,0
5116,10,6,1,5,4,4,11,36.4,7,6,1,5,1,11,13,0
5117,14,8,4,10,0,5,9,55.6,4,15,2,13,6,20,5,0
5118,3,0,3,0,0,3,3,100.0,0,0,0,0,0,3,3,0
5119,5,3,2,2,1,3,5,60.0,2,5,3,2,8,13,18,0
5120,19,8,8,8,3,7,24,29.2,17,18,7,11,8,27,5,0
5121,7,4,3,3,1,7,15,46.7,8,3,2,1,3,10,5,0
5122,6,2,3,2,1,2,3,66.7,1,9,2,7,1,7,16,0
5123,2,1,0,2,0,0,0,0.0,0,1,0,1,1,3,2,0
5124,1,0,0,0,1,1,4,25.0,3,2,0,2,0,1,0,0
5125,4,2,3,1,0,3,4,75.0,1,2,1,1,4,8,6,1
5126,9,2,4,3,2,3,7,42.9,4,6,4,2,9,18,7,0
5127,0,0,0,0,0,0,0,0.0,0,0,0,0,0,0,0,0
5128,0,0,0,0,0,0,1,0.0,1,0,0,0,0,0,0,0
5129,2,2,2,0,0,2,2,100.0,0,0,0,0,0,2,5,0
5130,38,23,14,19,5,16,47,34.0,31,29,2,27,10,48,11,1
5131,37,22,17,18,2,24,39,61.5,15,19,10,9,14,51,31,0
5132,61,36,36,24,1,32,47,68.1,15,27,5,22,21,82,46,0
5133,38,31,27,11,0,23,34,67.6,11,23,17,6,41,79,99,0
5134,46,36,11,31,4,22,63,34.9,41,35,5,30,17,63,16,1
5135,37,26,19,17,1,18,37,48.6,19,23,4,19,28,65,19,0
5136,8,6,2,3,3,5,23,21.7,18,18,2,16,4,12,3,0
5137,17,13,1,10,6,4,16,25.0,12,21,2,19,4,21,5,0
5138,28,18,4,17,7,14,28,50.0,14,8,0,8,5,33,6,0
5139,18,14,5,7,6,2,22,9.1,20,24,2,22,7,25,5,0
5140,18,10,13,5,0,12,20,60.0,8,12,8,4,19,37,59,0
5141,19,12,5,10,4,8,28,28.6,20,20,3,17,8,27,1,0
5142,13,8,7,5,1,8,13,61.5,5,10,5,5,4,17,41,0
5143,23,16,13,9,1,10,22,45.5,12,8,2,6,17,40,21,0
5144,6,4,0,4,2,1,2,50.0,1,6,0,6,0,6,10,0
5145,6,4,2,2,2,2,5,40.0,3,11,0,11,0,6,11,0
5146,27,19,9,13,5,13,30,43.3,17,9,1,8,5,32,10,0
5147,8,5,5,2,1,4,5,80.0,1,6,5,1,10,18,31,0
5148,2,1,1,1,0,1,2,50.0,1,7,4,3,5,7,22,0
5149,11,8,6,4,1,9,17,52.9,8,5,0,5,6,17,10,0
5150,7,5,1,6,0,4,11,36.4,7,2,0,2,1,8,9,0
5151,4,3,0,3,1,1,6,16.7,5,7,1,6,3,7,3,0
5152,0,0,0,0,0,0,0,0.0,0,0,0,0,0,0,1,0
5153,2,2,1,1,0,1,2,50.0,1,4,1,3,0,2,2,0
5154,2,1,0,1,1,1,2,50.0,1,3,0,3,0,2,0,0
5155,3,2,2,1,0,1,2,50.0,1,3,0,3,0,3,1,0
5156,0,0,0,0,0,0,1,0.0,1,0,0,0,0,0,0,0
5157,0,0,0,0,0,0,0,0.0,0,0,0,0,0,0,0,0
5158,2,1,2,0,0,2,3,66.7,1,0,0,0,1,3,11,0
5159,63,45,39,19,5,36,69,52.2,33,34,7,27,26,89,67,0
5160,23,17,15,7,1,10,16,62.5,6,22,9,13,27,50,118,0
5161,51,32,19,31,1,19,49,38.8,30,22,4,18,26,77,20,0
5162,27,17,7,16,4,11,45,24.4,34,19,0,19,15,42,5,0
5163,7,2,0,4,3,1,12,8.3,11,12,0,12,3,10,5,0
5164,10,6,3,6,1,4,15,26.7,11,17,1,16,5,15,4,0
5165,40,25,21,19,0,24,36,66.7,12,24,4,20,16,56,47,0
5166,33,24,13,18,2,10,28,35.7,18,29,5,24,10,43,23,0
5167,31,21,19,10,2,14,27,51.9,13,28,17,11,21,52,86,0
5168,23,16,8,13,2,9,29,31.0,20,13,3,10,6,29,14,0
5169,30,21,11,14,5,16,41,39.0,25,22,4,18,12,42,17,0
5170,20,9,2,15,3,8,19,42.1,11,19,5,14,8,28,18,0
5171,24,17,20,4,0,19,24,79.2,5,11,4,7,17,41,50,0
5172,9,8,5,4,0,3,8,37.5,5,6,0,6,6,15,13,0
5173,8,4,3,4,1,4,17,23.5,13,4,0,4,2,10,0,0
5174,2,2,0,2,0,1,4,25.0,3,4,1,3,0,2,0,0
5175,9,6,3,4,2,6,13,46.2,7,6,0,6,8,17,9,0
5176,2,1,2,0,0,1,3,33.3,2,2,1,1,2,4,9,0
5177,2,1,1,1,0,1,3,33.3,2,3,0,3,6,8,3,0
5178,3,1,2,1,0,0,2,0.0,2,1,1,0,0,3,2,0
5179,3,1,3,0,0,2,2,100.0,0,1,0,1,2,5,7,0
5180,1,1,1,0,0,1,1,100.0,0,1,0,1,3,4,2,0
5181,1,0,0,0,1,1,2,50.0,1,2,0,2,0,1,2,0
5182,6,4,2,3,1,3,5,60.0,2,5,0,5,1,7,1,0
5183,4,3,2,2,0,1,2,50.0,1,1,0,1,2,6,1,0
5184,3,2,1,2,0,0,1,0.0,1,0,0,0,1,4,0,0
5185,1,1,0,1,0,1,1,100.0,0,1,0,1,1,2,1,0
5186,1,0,0,1,0,0,0,0.0,0,1,0,1,0,1,0,0
5187,0,0,0,0,0,0,0,0.0,0,0,0,0,0,0,0,0
5188,0,0,0,0,0,0,1,0.0,1,0,0,0,0,0,0,0
5189,68,54,33,26,9,46,75,61.3,29,47,2,45,24,92,43,1
5190,32,22,20,12,0,14,37,37.8,23,16,7,9,25,57,62,0
5191,33,20,14,17,2,18,41,43.9,23,30,10,20,20,53,36,1
5192,53,30,30,22,1,33,52,63.5,19,28,12,16,45,98,69,0
5193,1,1,1,0,0,0,0,0.0,0,0,0,0,0,1,4,0
5194,24,14,2,16,6,9,29,31.0,20,13,0,13,2,26,20,0
5195,23,15,8,15,0,12,35,34.3,23,16,3,13,8,31,2,0
5196,22,8,16,6,0,9,16,56.3,7,18,8,10,14,36,65,1
5197,21,13,7,13,1,10,27,37.0,17,16,4,12,15,36,40,1
5198,29,19,10,14,5,10,28,35.7,18,23,3,20,3,32,15,0
5199,19,12,11,7,1,13,27,48.1,14,8,1,7,7,26,14,0
5200,26,18,16,7,3,15,33,45.5,18,16,8,8,16,42,44,0
5201,16,8,5,8,3,4,24,16.7,20,14,1,13,8,24,5,0
5202,10,6,3,4,3,4,14,28.6,10,7,0,7,2,12,8,0
5203,15,7,4,8,3,5,16,31.3,11,4,0,4,4,19,3,0
5204,14,7,13,1,0,8,13,61.5,5,5,3,2,17,31,20,0
5205,0,0,0,0,0,0,1,0.0,1,0,0,0,0,0,2,0
5206,10,7,3,7,0,4,12,33.3,8,5,2,3,4,14,9,0
5207,3,3,2,1,0,1,6,16.7,5,4,0,4,0,3,3,0
5208,2,1,0,2,0,0,2,0.0,2,3,1,2,0,2,2,0
5209,16,11,7,6,3,10,19,52.6,9,4,0,4,11,27,4,0
5210,4,4,4,0,0,1,2,50.0,1,3,3,0,1,5,13,0
5211,3,1,1,1,1,2,5,40.0,3,1,0,1,2,5,3,0
5212,1,1,0,1,0,0,4,0.0,4,2,0,2,1,2,6,0
5213,0,0,0,0,0,0,2,0.0,2,0,0,0,3,3,3,0
5214,1,1,1,0,0,0,0,0.0,0,0,0,0,0,1,2,0
5215,1,1,1,0,0,0,0,0.0,0,0,0,0,1,2,0,0
5216,2,2,1,1,0,1,3,33.3,2,0,0,0,0,2,0,0
5217,0,0,0,0,0,0,0,0.0,0,0,0,0,0,0,0,0
5218,28,19,14,12,2,19,32,59.4,13,32,14,18,21,49,131,0
5219,9,8,1,6,2,5,16,31.3,11,7,2,5,6,15,9,0
5220,35,17,13,15,7,13,39,33.3,26,20,3,17,11,46,29,0
5221,46,24,18,25,3,21,50,42.0,29,33,10,23,39,85,66,0
5222,77,52,39,31,7,41,67,61.2,26,31,4,27,31,108,63,0
5223,0,0,0,0,0,0,0,0.0,0,0,0,0,1,1,3,4
5224,24,15,6,16,2,12,46,26.1,34,21,3,18,16,40,15,0
5225,39,26,10,14,15,22,57,38.6,35,25,2,23,18,57,5,0
5226,41,28,30,8,3,17,38,44.7,21,15,4,11,15,56,46,0
5227,33,17,24,7,2,20,38,52.6,18,25,4,21,8,41,25,0
5228,12,6,4,6,2,4,25,16.0,21,16,1,15,2,14,2,0
5229,14,11,12,2,0,8,10,80.0,2,9,7,2,5,19,50,0
5230,21,9,6,14,1,8,19,42.1,11,13,1,12,14,35,11,0
5231,15,9,5,8,2,5,15,33.3,10,10,0,10,8,23,8,0
5232,6,5,4,2,0,4,14,28.6,10,10,7,3,14,20,76,1
5233,17,13,6,9,2,7,27,25.9,20,12,3,9,8,25,10,0
5234,26,16,11,14,1,15,44,34.1,29,20,5,15,22,48,29,0
5235,0,0,0,0,0,0,0,0.0,0,0,0,0,0,0,2,1
5236,5,3,4,1,0,2,3,66.7,1,9,6,3,4,9,36,0
5237,7,3,6,0,1,1,4,25.0,3,3,0,3,5,12,4,1
5238,4,2,4,0,0,2,3,66.7,1,3,1,2,2,6,7,0
5239,6,5,3,1,2,3,9,33.3,6,2,0,2,7,13,5,0
5240,1,1,0,0,1,0,1,0.0,1,0,0,0,0,1,3,0
5241,3,2,0,2,1,1,3,33.3,2,5,0,5,1,4,5,0
5242,2,1,1,0,1,2,5,40.0,3,2,0,2,2,4,0,0
5243,4,3,2,1,1,2,2,100.0,0,2,1,1,0,4,1,0
5244,0,0,0,0,0,0,1,0.0,1,1,0,1,0,0,5,0
5245,1,1,0,1,0,1,1,100.0,0,0,0,0,0,1,0,0
5246,2,1,0,2,0,1,1,100.0,0,1,0,1,1,3,0,0
5247,0,0,0,0,0,0,0,0.0,0,0,0,0,0,0,0,0
5248,69,39,24,43,2,30,60,50.0,30,35,10,25,27,96,71,2
5249,28,16,11,11,6,13,36,36.1,23,18,1,17,7,35,7,1
5250,1,1,1,0,0,1,2,50.0,1,0,0,0,2,3,2,0
5251,71,42,27,36,8,32,92,34.8,60,47,5,42,35,106,24,0
5252,41,29,28,12,1,20,26,76.9,6,23,15,8,21,62,124,0
5253,28,20,16,10,2,18,24,75.0,6,23,14,9,31,59,72,1
5254,19,15,12,5,2,13,26,50.0,13,16,2,14,16,35,30,1
5255,3,1,0,2,1,1,10,10.0,9,2,0,2,0,3,16,0
5256,33,23,9,19,5,13,41,31.7,28,27,7,20,12,45,14,1
5257,40,27,21,16,3,20,41,48.8,21,18,3,15,22,62,33,0
5258,28,16,20,7,1,15,24,62.5,9,14,11,3,29,57,69,0
5259,21,14,12,7,2,15,25,60.0,10,12,4,8,8,29,20,1
5260,2,0,1,1,0,0,3,0.0,3,6,0,6,2,4,6,0
5261,3,1,1,2,0,1,5,20.0,4,6,0,6,0,3,3,0
5262,25,19,8,10,7,10,27,37.0,17,16,1,15,4,29,8,0
5263,19,12,6,11,2,9,23,39.1,14,7,0,7,6,25,17,0
5264,15,8,6,5,4,3,14,21.4,11,5,0,5,2,17,3,0
5265,8,6,3,5,0,3,13,23.1,10,9,1,8,0,8,1,0
5266,9,5,3,5,1,4,12,33.3,8,2,0,2,1,10,0,0
5267,4,3,2,1,1,2,3,66.7,1,2,2,0,1,5,8,0
5268,5,4,4,1,0,3,7,42.9,4,1,1,0,3,8,12,0
5269,0,0,0,0,0,0,0,0.0,0,0,0,0,0,0,0,0
5270,3,3,0,3,0,0,0,0.0,0,0,0,0,1,4,1,0
5271,5,1,3,2,0,1,2,50.0,1,1,0,1,2,7,2,0
5272,0,0,0,0,0,0,0,0.0,0,2,0,2,0,0,0,0
5273,1,0,0,0,1,0,1,0.0,1,0,0,0,0,1,0,0
5274,1,1,1,0,0,1,3,33.3,2,0,0,0,0,1,1,0
5275,1,1,1,0,0,1,1,100.0,0,0,0,0,1,2,0,0
5276,1,1,1,0,0,1,1,100.0,0,1,0,1,0,1,0,0
5277,13,7,3,3,7,4,22,18.2,18,15,3,12,0,13,25,0
5278,50,31,27,21,2,25,58,43.1,33,29,7,22,35,85,67,1
5279,33,22,21,11,1,12,23,52.2,11,33,18,15,36,69,116,0
5280,70,36,35,30,5,29,68,42.6,39,35,5,30,27,97,35,1
5281,0,0,0,0,0,0,0,0.0,0,1,0,1,1,1,7,0
5282,60,36,37,14,9,36,64,56.3,28,23,9,14,33,93,65,1
5283,51,19,15,33,3,20,64,31.3,44,27,7,20,13,64,24,0
5284,22,15,12,9,1,15,24,62.5,9,23,19,4,27,49,88,1
5285,23,16,3,17,3,12,21,57.1,9,20,0,20,7,30,14,0
5286,38,27,19,16,3,17,31,54.8,14,16,1,15,12,50,6,0
5287,5,2,1,4,0,3,16,18.8,13,20,2,18,3,8,12,0
5288,24,16,13,7,4,9,27,33.3,18,14,2,12,6,30,17,0
5289,14,8,9,4,1,4,9,44.4,5,11,4,7,14,28,52,2
5290,11,6,4,7,0,8,20,40.0,12,6,1,5,6,17,5,0
5291,20,11,7,8,5,9,16,56.3,7,13,2,11,10,30,13,0
5292,15,8,6,9,0,7,24,29.2,17,13,4,9,6,21,5,0
5293,0,0,0,0,0,0,0,0.0,0,0,0,0,0,0,3,0
5294,14,8,8,4,2,4,13,30.8,9,14,1,13,9,23,15,0
5295,3,1,1,2,0,0,0,0.0,0,7,3,4,7,10,37,0
5296,9,7,4,5,0,7,19,36.8,12,10,3,7,6,15,10,1
5297,2,2,1,1,0,2,3,66.7,1,4,2,2,0,2,2,0
5298,4,2,2,0,2,1,1,100.0,0,0,0,0,0,4,1,0
5299,0,0,0,0,0,0,3,0.0,3,0,0,0,1,1,3,0
5300,0,0,0,0,0,0,2,0.0,2,2,0,2,0,0,0,0
5301,2,2,2,0,0,1,1,100.0,0,1,0,1,1,3,4,0
5302,1,1,0,1,0,1,1,100.0,0,0,0,0,1,2,6,0
5303,2,0,1,0,1,1,2,50.0,1,3,0,3,0,2,0,0
5304,1,1,1,0,0,1,3,33.3,2,0,0,0,1,2,1,0
5305,3,2,2,1,0,3,7,42.9,4,1,0,1,1,4,3,0
5306,1,1,0,1,0,0,0,0.0,0,0,0,0,2,3,0,0
5307,1,1,0,0,1,0,0,0.0,0,0,0,0,0,1,0,0
5308,0,0,0,0,0,0,0,0.0,0,0,0,0,0,0,0,0
5309,1,1,1,0,0,0,0,0.0,0,0,0,0,0,1,1,0
5310,0,0,0,0,0,0,0,0.0,0,0,0,0,1,1,0,0
5311,1,1,1,0,0,1,2,50.0,1,0,0,0,2,3,6,0
5312,35,27,26,8,1,20,29,69.0,9,29,18,11,15,50,63,2
5313,42,26,18,21,3,21,53,39.6,32,27,8,19,20,62,18,1
5314,47,21,19,28,0,23,48,47.9,25,34,13,21,28,75,21,0
5315,35,20,17,17,1,21,27,77.8,6,20,4,16,6,41,16,0
5316,22,14,11,10,1,12,17,70.6,5,21,11,10,24,46,52,0
5317,28,21,17,7,4,15,27,55.6,12,13,5,8,21,49,27,0
5318,15,11,4,9,2,7,16,43.8,9,11,0,11,8,23,3,0
5319,24,17,15,7,2,16,28,57.1,12,21,3,18,11,35,35,1
5320,33,19,12,15,6,18,37,48.6,19,14,1,13,5,38,9,0
5321,7,6,0,4,3,2,7,28.6,5,6,0,6,1,8,6,1
5322,18,13,3,12,3,10,28,35.7,18,9,0,9,7,25,4,0
5323,3,0,0,2,1,1,7,14.3,6,6,1,5,1,4,4,0
5324,16,11,8,8,0,12,16,75.0,4,8,5,3,9,25,53,0
5325,19,15,9,8,2,7,17,41.2,10,7,1,6,8,27,9,1
5326,36,23,10,23,3,14,29,48.3,15,25,2,23,18,54,3,1
5327,23,14,15,8,0,14,20,70.0,6,15,9,6,17,40,36,1
5328,8,4,3,5,0,4,11,36.4,7,3,0,3,2,10,1,0
5329,16,9,5,7,4,5,11,45.5,6,10,0,10,4,20,1,0
5330,14,11,2,11,1,5,11,45.5,6,7,0,7,1,15,3,0
5331,8,8,5,3,0,5,10,50.0,5,5,0,5,4,12,11,2
5332,5,4,1,4,0,1,6,16.7,5,2,1,1,0,5,3,0
5333,0,0,0,0,0,0,0,0.0,0,0,0,0,0,0,0,0
5334,1,1,0,0,1,0,0,0.0,0,4,1,3,1,2,1,0
5335,6,5,0,5,1,0,5,0.0,5,6,0,6,0,6,0,0
5336,11,3,5,5,1,8,10,80.0,2,4,0,4,0,11,2,0
5337,1,1,1,0,0,1,2,50.0,1,1,0,1,0,1,1,0
5338,3,1,0,2,1,0,0,0.0,0,4,0,4,0,3,0,0
5339,2,1,1,1,0,2,2,100.0,0,0,0,0,1,3,2,0
5340,0,0,0,0,0,0,1,0.0,1,2,1,1,2,2,0,0
5341,0,0,0,0,0,0,1,0.0,1,2,0,2,1,1,0,0
5342,0,0,0,0,0,0,0,0.0,0,0,0,0,0,0,0,0
5343,36,20,24,11,1,22,39,56.4,17,25,18,7,52,88,154,1
5344,47,31,27,18,2,32,63,50.8,31,26,6,20,29,76,68,0
5345,13,9,3,6,4,7,36,19.4,29,16,0,16,2,15,3,1
5346,56,33,33,17,6,30,63,47.6,33,26,7,19,23,79,35,0
5347,65,41,45,19,1,33,49,67.3,16,30,18,12,44,109,132,1
5348,0,0,0,0,0,0,1,0.0,1,1,0,1,1,1,4,1
5349,76,47,40,30,6,34,98,34.7,64,51,12,39,47,123,46,0
5350,45,27,16,23,6,22,49,44.9,27,27,1,26,6,51,5,0
5351,5,3,1,2,2,2,6,33.3,4,12,3,9,2,7,36,0
5352,52,35,19,29,4,21,56,37.5,35,25,3,22,19,71,28,0
5353,12,9,6,2,4,6,27,22.2,21,17,4,13,6,18,14,0
5354,17,8,11,6,0,10,16,62.5,6,10,5,5,14,31,63,0
5355,25,19,13,10,2,14,44,31.8,30,14,2,12,13,38,9,0
5356,18,11,6,9,3,14,26,53.8,12,10,0,10,5,23,2,0
5357,3,3,0,2,1,3,5,60.0,2,5,0,5,3,6,8,0
5358,15,11,5,10,0,11,24,45.8,13,9,0,9,12,27,10,0
5359,0,0,0,0,0,0,0,0.0,0,0,0,0,0,0,3,3
5360,6,2,0,2,4,2,6,33.3,4,1,1,0,2,8,1,0
5361,21,14,11,8,2,13,24,54.2,11,5,0,5,5,26,25,1
5362,6,2,4,2,0,4,8,50.0,4,2,2,0,2,8,5,0
5363,4,2,1,3,0,2,3,66.7,1,2,0,2,0,4,0,0
5364,5,3,3,2,0,3,8,37.5,5,3,0,3,0,5,0,0
5365,4,1,2,2,0,1,4,25.0,3,1,0,1,3,7,11,0
5366,5,2,1,2,2,2,4,50.0,2,4,0,4,0,5,7,0
5367,2,1,1,1,0,2,3,66.7,1,2,1,1,0,2,3,0
5368,8,5,4,3,1,6,8,75.0,2,1,0,1,1,9,1,0
5369,0,0,0,0,0,0,1,0.0,1,1,1,0,0,0,2,1
5370,2,2,2,0,0,1,1,100.0,0,1,0,1,1,3,11,2
5371,64,36,41,22,1,35,55,63.6,20,34,17,17,51,115,135,1
5372,49,30,16,27,6,24,58,41.4,34,37,6,31,21,70,21,0
5373,50,35,18,27,5,20,75,26.7,55,37,3,34,17,67,25,0
5374,33,18,26,6,1,21,37,56.8,16,28,10,18,17,50,78,0
5375,51,31,26,22,3,35,70,50.0,35,30,4,26,26,77,73,0
5376,11,7,1,8,2,1,13,7.7,12,16,3,13,3,14,11,0
5377,39,21,4,25,10,8,36,22.2,28,18,1,17,8,47,6,0
5378,28,20,10,12,6,17,40,42.5,23,13,1,12,9,37,9,0
5379,23,14,10,13,0,13,30,43.3,17,21,3,18,31,54,20,0
5380,32,16,15,16,1,20,33,60.6,13,26,8,18,22,54,29,1
5381,25,16,7,14,4,12,39,30.8,27,22,3,19,8,33,11,0
5382,29,14,16,10,3,16,33,48.5,17,13,3,10,20,49,36,0
5383,12,4,2,9,1,8,16,50.0,8,10,3,7,13,25,8,0
5384,9,7,5,4,0,2,2,100.0,0,6,3,3,13,22,30,0
5385,3,2,0,2,1,0,8,0.0,8,6,1,5,6,9,5,0
5386,8,4,5,3,0,5,8,62.5,3,6,4,2,0,8,7,0
5387,22,17,11,11,0,9,18,50.0,9,6,0,6,7,29,10,0
5388,7,1,1,5,1,3,6,50.0,3,5,0,5,0,7,5,0
5389,7,5,2,4,1,5,7,71.4,2,3,0,3,2,9,2,0
5390,6,3,6,0,0,3,6,50.0,3,3,2,1,2,8,9,0
5391,0,0,0,0,0,0,1,0.0,1,2,0,2,0,0,0,0
5392,3,1,1,1,1,3,6,50.0,3,4,0,4,1,4,3,0
5393,1,0,1,0,0,1,1,100.0,0,0,0,0,0,1,3,1
5394,3,3,2,1,0,3,7,42.9,4,0,0,0,2,5,11,0
5395,0,0,0,0,0,0,0,0.0,0,2,0,2,0,0,0,0
5396,0,0,0,0,0,0,1,0.0,1,0,0,0,0,0,0,0
5397,0,0,0,0,0,0,0,0.0,0,0,0,0,0,0,0,0
5398,47,26,23,20,4,24,40,60.0,16,16,11,5,49,96,78,1
5399,7,4,0,3,4,2,9,22.2,7,9,1,8,3,10,12,0
5400,59,38,29,27,3,30,57,52.6,27,37,8,29,27,86,56,0
5401,33,22,9,17,7,9,36,25.0,27,21,1,20,7,40,7,0
5402,28,25,10,12,6,13,41,31.7,28,22,1,21,10,38,17,0
5403,37,22,15,13,9,24,43,55.8,19,22,3,19,15,52,14,0
5404,29,18,11,16,2,14,30,46.7,16,10,3,7,14,43,19,1
5405,15,11,11,3,1,10,14,71.4,4,15,9,6,13,28,53,0
5406,17,9,1,8,8,8,15,53.3,7,13,4,9,3,20,10,0
5407,0,0,0,0,0,0,1,0.0,1,0,0,0,1,1,6,1
5408,32,19,16,12,4,11,28,39.3,17,20,5,15,11,43,16,1
5409,2,1,2,0,0,2,2,100.0,0,0,0,0,0,2,8,0
5410,36,25,9,19,8,11,29,37.9,18,10,3,7,11,47,7,0
5411,20,12,17,3,0,15,20,75.0,5,10,7,3,14,34,70,0
5412,7,4,0,3,4,2,10,20.0,8,16,0,16,1,8,6,0
5413,26,18,19,6,1,17,33,51.5,16,15,3,12,11,37,19,1
5414,11,6,5,5,1,6,13,46.2,7,4,0,4,5,16,1,0
5415,26,15,8,15,3,12,20,60.0,8,15,0,15,13,39,4,0
5416,5,4,3,1,1,0,0,0.0,0,5,0,5,2,7,3,0
5417,13,12,3,9,1,7,13,53.8,6,10,2,8,4,17,9,1
5418,5,3,5,0,0,2,5,40.0,3,9,3,6,6,11,18,0
5419,4,3,3,1,0,3,13,23.1,10,4,0,4,2,6,11,0
5420,6,2,5,1,0,3,3,100.0,0,4,2,2,3,9,11,0
5421,6,4,0,1,5,1,6,16.7,5,6,0,6,0,6,0,0
5422,2,1,0,2,0,0,1,0.0,1,1,0,1,0,2,2,0
5423,2,2,2,0,0,1,1,100.0,0,0,0,0,0,2,2,0
5424,1,1,1,0,0,1,1,100.0,0,0,0,0,0,1,6,2
5425,59,40,34,25,0,29,61,47.5,32,38,9,29,30,89,55,0
5426,57,37,16,35,6,27,69,39.1,42,37,5,32,22,79,31,0
5427,14,9,1,7,6,7,18,38.9,11,13,0,13,3,17,1,0
5428,46,26,37,8,1,25,39,64.1,14,34,24,10,32,78,131,0
5429,39,29,21,14,4,23,45,51.1,22,19,7,12,26,65,31,2
5430,28,16,24,4,0,15,31,48.4,16,25,12,13,26,54,97,0
5431,19,10,1,13,5,5,15,33.3,10,19,1,18,3,22,29,0
5432,62,40,26,29,7,39,78,50.0,39,49,6,43,14,76,46,1
5433,43,25,18,21,4,22,47,46.8,25,33,4,29,13,56,33,0
5434,42,21,18,22,2,15,34,44.1,19,18,2,16,28,70,20,0
5435,20,11,10,10,0,10,20,50.0,10,14,6,8,16,36,35,0
5436,11,9,4,6,1,5,15,33.3,10,6,2,4,4,15,9,0
5437,20,17,13,6,1,9,20,45.0,11,4,0,4,3,23,12,0
5438,13,5,6,5,2,1,16,6.3,15,6,2,4,2,15,9,0
5439,4,3,1,3,0,3,11,27.3,8,9,7,2,9,13,30,2
5440,7,4,7,0,0,4,5,80.0,1,3,3,0,2,9,8,0
5441,5,5,1,3,1,4,9,44.4,5,5,1,4,1,6,1,0
5442,4,4,3,1,0,3,7,42.9,4,3,0,3,3,7,7,0
5443,2,2,1,1,0,0,2,0.0,2,5,2,3,2,4,2,0
5444,4,1,2,1,1,0,3,0.0,3,5,0,5,0,4,5,0
5445,5,4,0,4,1,2,4,50.0,2,5,0,5,0,5,1,0
5446,5,4,3,1,1,2,5,40.0,3,2,0,2,0,5,11,0
5447,3,2,1,2,0,1,1,100.0,0,0,0,0,0,3,0,0
5448,0,0,0,0,0,0,0,0.0,0,0,0,0,0,0,0,0
5449,1,1,1,0,0,0,0,0.0,0,0,0,0,0,1,0,0
5450,0,0,0,0,0,0,3,0.0,3,2,0,2,0,0,8,1
5451,51,35,21,27,3,26,60,43.3,34,19,3,16,27,78,32,0
5452,26,17,19,7,0,15,29,51.7,14,22,13,9,23,49,80,0
5453,44,29,24,18,2,23,52,44.2,29,17,4,13,29,73,89,0
5454,37,22,9,21,7,16,42,38.1,26,12,1,11,11,48,11,0
5455,29,14,20,5,4,20,36,55.6,16,19,4,15,18,47,37,1
5456,12,10,2,9,1,5,23,21.7,18,14,0,14,4,16,6,0
5457,6,5,1,4,1,2,4,50.0,2,1,1,0,3,9,16,0
5458,43,27,22,18,3,28,59,47.5,31,24,6,18,15,58,24,0
5459,22,16,13,5,4,15,34,44.1,19,11,3,8,10,32,36,0
5460,22,16,9,8,5,12,32,37.5,20,16,2,14,14,36,5,0
5461,21,13,10,8,3,12,23,52.2,11,8,1,7,2,23,0,0
5462,30,21,18,10,2,11,28,39.3,17,15,5,10,17,47,26,0
5463,21,14,13,8,0,11,17,64.7,6,8,4,4,16,37,25,0
5464,6,3,5,1,0,3,13,23.1,10,9,5,4,5,11,24,1
5465,8,5,5,2,1,3,16,18.8,13,7,3,4,3,11,8,0
5466,11,10,10,1,0,4,9,44.4,5,9,7,2,13,24,33,0
5467,2,0,0,1,1,1,4,25.0,3,5,0,5,3,5,0,0
5468,1,0,1,0,0,0,2,0.0,2,3,0,3,0,1,5,0
5469,15,11,3,10,2,2,16,12.5,14,3,0,3,1,16,3,0
5470,4,3,1,3,0,0,2,0.0,2,1,0,1,1,5,7,0
5471,8,6,1,5,2,1,6,16.7,5,6,0,6,1,9,5,0
5472,15,11,8,7,0,5,11,45.5,6,3,0,3,6,21,7,1
5473,0,0,0,0,0,0,0,0.0,0,0,0,0,0,0,1,0
5474,7,2,4,3,0,3,10,30.0,7,1,0,1,2,9,4,0
5475,9,6,6,3,0,5,8,62.5,3,7,1,6,4,13,8,0
5476,2,2,1,0,1,0,1,0.0,1,2,0,2,1,3,0,0
5477,1,1,0,0,1,1,3,33.3,2,1,0,1,0,1,0,0
5478,1,1,1,0,0,1,2,50.0,1,1,0,1,0,1,0,0
5479,2,2,2,0,0,0,0,0.0,0,1,0,1,1,3,1,0
5480,1,1,1,0,0,0,3,0.0,3,0,0,0,0,1,1,0
5481,0,0,0,0,0,0,1,0.0,1,0,0,0,0,0,4,0
5482,3,3,1,1,1,2,3,66.7,1,1,0,1,0,3,0,0
5483,1,0,1,0,0,0,0,0.0,0,0,0,0,0,1,0,0
5484,0,0,0,0,0,0,0,0.0,0,0,0,0,0,0,0,0
5485,0,0,0,0,0,0,0,0.0,0,0,0,0,0,0,0,0
5486,88,59,46,39,3,47,100,47.0,53,30,4,26,28,116,32,0
5487,8,5,2,5,1,4,22,18.2,18,15,3,12,1,9,30,0
5488,1,1,1,0,0,1,1,100.0,0,1,0,1,0,1,11,3
5489,35,19,18,15,2,17,51,33.3,34,29,5,24,13,48,18,0
5490,18,9,14,4,0,9,19,47.4,10,12,7,5,41,59,97,0
5491,37,26,8,26,3,19,53,35.8,34,22,2,20,11,48,10,1
5492,26,16,20,5,1,13,27,48.1,14,24,8,16,27,53,71,0
5493,42,28,28,12,2,28,44,63.6,16,16,2,14,19,61,30,0
5494,11,9,5,5,1,8,11,72.7,3,18,10,8,18,29,61,0
5495,13,8,4,9,0,8,13,61.5,5,4,2,2,3,16,24,1
5496,32,21,8,23,1,14,35,40.0,21,15,8,7,19,51,12,0
5497,16,7,2,9,5,3,16,18.8,13,15,0,15,1,17,14,0
5498,27,15,17,7,3,16,26,61.5,10,13,4,9,10,37,22,0
5499,17,9,10,6,1,7,13,53.8,6,5,1,4,8,25,21,0
5500,30,13,6,17,7,15,26,57.7,11,9,1,8,5,35,8,0
5501,8,6,1,4,3,4,9,44.4,5,10,0,10,2,10,5,0
5502,8,4,2,4,2,5,11,45.5,6,2,0,2,2,10,2,0
5503,20,16,7,9,4,9,24,37.5,15,8,1,7,9,29,16,0
5504,1,0,0,1,0,1,1,100.0,0,2,1,1,5,6,10,0
5505,12,9,3,7,2,5,13,38.5,8,13,2,11,5,17,10,0
5506,5,4,5,0,0,3,3,100.0,0,2,1,1,7,12,21,0
5507,3,3,2,1,0,2,3,66.7,1,5,0,5,2,5,2,0
5508,0,0,0,0,0,0,5,0.0,5,2,0,2,1,1,1,0
5509,2,1,0,2,0,0,1,0.0,1,2,0,2,1,3,0,0
5510,0,0,0,0,0,0,0,0.0,0,0,0,0,1,1,0,0
5511,2,2,1,1,0,1,1,100.0,0,1,0,1,2,4,5,0
5512,3,0,1,1,1,1,1,100.0,0,3,1,2,0,3,8,0
5513,4,4,3,1,0,3,8,37.5,5,5,0,5,2,6,4,0
5514,2,1,0,2,0,1,3,33.3,2,1,0,1,0,2,2,0
5515,0,0,0,0,0,0,0,0.0,0,1,0,1,0,0,0,0
5516,1,1,1,0,0,1,1,100.0,0,0,0,0,1,2,1,0
5517,1,1,1,0,0,1,1,100.0,0,2,0,2,2,3,0,0
5518,2,2,2,0,0,2,2,100.0,0,0,0,0,1,3,11,2
5519,46,27,14,29,3,20,48,41.7,28,24,4,20,26,72,38,0
5520,14,8,2,8,4,3,17,17.6,14,13,3,10,3,17,11,0
5521,52,31,18,23,11,26,57,45.6,31,25,1,24,21,73,22,1
5522,38,24,21,15,2,13,33,39.4,20,11,2,9,32,70,23,0
5523,27,19,21,6,0,17,27,63.0,10,10,6,4,33,60,81,0
5524,20,9,5,10,5,7,27,25.9,20,11,2,9,5,25,5,0
5525,28,17,13,11,4,14,28,50.0,14,19,1,18,6,34,5,0
5526,11,7,10,1,0,6,8,75.0,2,16,10,6,14,25,56,0
5527,38,27,23,12,3,19,36,52.8,17,16,3,13,14,52,27,0
5528,15,7,8,5,2,6,19,31.6,13,9,0,9,2,17,1,0
5529,17,11,15,2,0,11,15,73.3,4,11,7,4,14,31,51,0
5530,12,6,8,3,1,9,13,69.2,4,13,8,5,27,39,39,1
5531,26,17,10,14,2,12,32,37.5,20,14,1,13,12,38,15,1
5532,16,10,11,2,3,6,9,66.7,3,16,6,10,22,38,14,0
5533,15,10,10,3,2,11,16,68.8,5,9,1,8,4,19,5,0
5534,10,9,5,3,2,8,16,50.0,8,7,0,7,3,13,4,0
5535,2,2,0,2,0,1,8,12.5,7,7,0,7,1,3,3,0
5536,8,5,3,4,1,3,11,27.3,8,7,0,7,9,17,1,0
5537,4,1,1,3,0,1,9,11.1,8,4,0,4,0,4,2,0
5538,7,4,1,4,2,4,15,26.7,11,5,1,4,2,9,4,0
5539,8,7,1,7,0,4,5,80.0,1,1,0,1,3,11,0,0
5540,0,0,0,0,0,0,2,0.0,2,2,0,2,0,0,0,0
5541,2,2,2,0,0,1,2,50.0,1,0,0,0,0,2,3,0
5542,1,1,0,1,0,0,0,0.0,0,0,0,0,1,2,2,0
5543,1,0,0,1,0,1,1,100.0,0,4,3,1,1,2,5,0
5544,0,0,0,0,0,0,1,0.0,1,1,0,1,2,2,0,0
5545,0,0,0,0,0,0,0,0.0,0,0,0,0,0,0,0,0
5546,2,2,0,2,0,2,2,100.0,0,0,0,0,0,2,0,0
5547,0,0,0,0,0,0,0,0.0,0,0,0,0,0,0,0,0
5548,1,1,1,0,0,0,0,0.0,0,0,0,0,0,1,0,0
5549,1,1,0,1,0,1,1,100.0,0,0,0,0,0,1,1,0
5550,38,22,10,21,7,21,59,35.6,38,20,1,19,12,50,15,0
5551,41,19,33,8,0,24,39,61.5,15,30,11,19,46,87,121,1
5552,2,0,2,0,0,2,3,66.7,1,2,0,2,1,3,16,1
5553,13,7,1,5,7,5,23,21.7,18,20,8,12,1,14,31,0
5554,55,36,27,15,13,36,73,49.3,37,27,1,26,19,74,37,0
5555,28,20,13,12,3,20,34,58.8,14,20,5,15,28,56,50,0
5556,55,35,30,23,2,22,43,51.2,21,31,11,20,44,99,69,0
5557,51,33,21,27,3,27,47,57.4,20,35,7,28,16,67,45,0
5558,41,29,19,17,5,17,30,56.7,13,22,3,19,14,55,10,0
5559,32,18,18,12,2,20,32,62.5,12,20,7,13,25,57,71,1
5560,28,19,16,7,5,21,33,63.6,12,19,3,16,13,41,36,0
5561,40,28,20,18,2,19,45,42.2,26,26,3,23,18,58,20,0
5562,12,5,5,4,3,8,21,38.1,13,12,0,12,7,19,5,0
5563,9,5,1,6,2,3,10,30.0,7,8,0,8,0,9,9,0
5564,7,5,1,6,0,4,11,36.4,7,4,0,4,3,10,0,0
5565,7,4,6,1,0,6,12,50.0,6,6,1,5,8,15,20,1
5566,11,6,4,4,3,6,14,42.9,8,3,0,3,4,15,5,0
5567,4,4,3,1,0,3,5,60.0,2,3,1,2,4,8,5,0
5568,11,7,6,5,0,7,14,50.0,7,5,3,2,8,19,16,0
5569,8,6,3,4,1,2,10,20.0,8,4,0,4,1,9,1,0
5570,2,1,2,0,0,2,2,100.0,0,0,0,0,0,2,2,0
5571,5,3,2,1,2,3,11,27.3,8,2,0,2,1,6,5,0
5572,2,2,1,1,0,1,5,20.0,4,0,0,0,6,8,5,0
5573,2,1,0,2,0,0,2,0.0,2,0,0,0,0,2,0,0
5574,2,1,0,1,1,0,2,0.0,2,1,0,1,0,2,1,0
5575,0,0,0,0,0,0,0,0.0,0,1,0,1,0,0,0,0
5576,0,0,0,0,0,0,0,0.0,0,2,1,1,0,0,1,0
5577,0,0,0,0,0,0,0,0.0,0,0,0,0,0,0,1,0
5578,0,0,0,0,0,0,0,0.0,0,0,0,0,0,0,0,0
5579,0,0,0,0,0,0,0,0.0,0,0,0,0,0,0,1,0
5580,0,0,0,0,0,0,2,0.0,2,0,0,0,2,2,9,7
5581,46,32,34,9,3,27,32,84.4,5,26,13,13,34,80,106,0
5582,15,13,3,9,3,2,15,13.3,13,12,2,10,2,17,17,0
5583,17,7,3,9,5,9,23,39.1,14,17,0,17,1,18,6,1
5584,49,25,15,29,5,27,62,43.5,35,25,3,22,17,66,15,0
5585,31,18,10,14,7,18,46,39.1,28,22,1,21,17,48,9,1
5586,12,8,5,4,3,3,12,25.0,9,11,1,10,11,23,3,0
5587,46,26,19,21,6,29,48,60.4,19,19,3,16,12,58,42,0
5588,39,24,22,12,5,23,53,43.4,30,28,4,24,29,68,37,1
5589,12,6,10,1,1,7,15,46.7,8,10,6,4,24,36,71,2
5590,24,14,6,9,9,12,19,63.2,7,20,1,19,10,34,13,0
5591,48,36,20,27,1,16,41,39.0,25,16,3,13,21,69,18,0
5592,27,15,15,10,2,14,26,53.8,12,11,2,9,21,48,22,0
5593,30,19,18,11,1,15,26,57.7,11,13,7,6,23,53,49,0
5594,27,14,12,13,2,11,31,35.5,20,22,0,22,16,43,26,2
5595,6,3,4,1,1,3,20,15.0,17,15,5,10,13,19,20,0
5596,18,12,7,9,2,11,19,57.9,8,10,2,8,5,23,21,1
5597,15,9,12,2,1,9,10,90.0,1,8,3,5,15,30,36,0
5598,2,0,1,0,1,1,6,16.7,5,4,1,3,3,5,4,0
5599,7,5,3,4,0,4,10,40.0,6,18,4,14,5,12,11,0
5600,10,5,2,5,3,7,10,70.0,3,4,1,3,2,12,3,0
5601,0,0,0,0,0,0,0,0.0,0,0,0,0,0,0,1,0
5602,7,5,3,3,1,3,6,50.0,3,4,2,2,3,10,1,0
5603,3,1,0,2,1,1,4,25.0,3,3,0,3,0,3,2,0
5604,2,0,0,0,2,0,1,0.0,1,2,0,2,0,2,1,0
5605,1,1,0,1,0,0,0,0.0,0,0,0,0,0,1,0,0
5606,0,0,0,0,0,0,0,0.0,0,2,0,2,1,1,0,0
5607,66,39,25,34,7,29,72,40.3,43,44,3,41,27,93,24,0
5608,0,0,0,0,0,0,2,0.0,2,1,0,1,1,1,6,1
5609,49,28,27,12,10,25,46,54.3,21,32,8,24,13,62,63,0
5610,35,26,13,19,3,13,36,36.1,23,23,0,23,8,43,1,0
5611,10,6,2,6,2,2,9,22.2,7,8,2,6,1,11,17,0
5612,13,8,4,7,2,4,21,19.0,17,11,4,7,11,24,25,0
5613,40,26,17,23,0,29,43,67.4,14,20,9,11,37,77,73,0
5614,30,19,19,10,1,22,34,64.7,12,25,12,13,20,50,130,0
5615,35,22,19,9,7,20,37,54.1,17,24,9,15,13,48,43,0
5616,49,37,19,28,2,23,52,44.2,29,24,4,20,32,81,23,0
5617,45,28,18,24,3,24,54,44.4,30,29,3,26,17,62,22,0
5618,29,15,11,14,4,13,27,48.1,14,19,5,14,16,45,25,0
5619,21,12,11,8,2,12,33,36.4,21,22,1,21,4,25,8,0
5620,18,10,9,9,0,7,8,87.5,1,12,7,5,27,45,63,0
5621,0,0,0,0,0,0,4,0.0,4,4,0,4,0,0,12,0
5622,22,12,8,12,2,10,25,40.0,15,12,5,7,7,29,14,0
5623,10,4,5,5,0,7,10,70.0,3,9,6,3,8,18,56,1
5624,0,0,0,0,0,0,0,0.0,0,0,0,0,0,0,2,1
5625,11,10,8,3,0,8,11,72.7,3,5,0,5,0,11,6,0
5626,14,7,14,0,0,10,22,45.5,12,11,2,9,8,22,12,0
5627,10,4,2,6,2,9,15,60.0,6,7,0,7,4,14,0,0
5628,10,6,5,5,0,3,15,20.0,12,9,1,8,2,12,4,0
5629,2,2,1,1,0,1,7,14.3,6,1,0,1,3,5,10,0
5630,8,6,6,2,0,6,7,85.7,1,1,1,0,0,8,9,0
5631,4,3,1,3,0,3,6,50.0,3,1,0,1,1,5,5,0
5632,1,1,0,0,1,1,9,11.1,8,2,0,2,0,1,3,0
5633,2,2,0,2,0,1,6,16.7,5,1,0,1,0,2,3,0
5634,1,1,0,1,0,1,2,50.0,1,0,0,0,1,2,1,0
5635,65,43,33,25,7,32,90,35.6,58,45,4,41,22,87,20,0
5636,47,29,31,15,1,30,45,66.7,15,30,14,16,27,74,140,1
5637,22,14,1,17,4,7,26,26.9,19,19,5,14,1,23,24,0
5638,47,32,32,13,2,27,49,55.1,22,20,5,15,27,74,53,1
5639,48,31,21,17,10,19,42,45.2,23,20,3,17,8,56,32,0
5640,18,10,1,11,6,6,19,31.6,13,20,0,20,3,21,2,0
5641,52,36,22,22,8,26,59,44.1,33,20,5,15,28,80,27,0
5642,30,17,18,12,0,21,33,63.6,12,13,5,8,30,60,65,0
5643,1,1,1,0,0,1,3,33.3,2,0,0,0,0,1,11,0
5644,29,18,15,10,4,13,41,31.7,28,20,5,15,17,46,44,0
5645,20,13,7,10,3,11,30,36.7,19,16,0,16,4,24,5,0
5646,29,17,7,19,3,15,28,53.6,13,19,3,16,17,46,18,0
5647,22,17,10,8,4,7,26,26.9,19,20,0,20,8,30,21,0
5648,14,12,6,6,2,4,6,66.7,2,8,2,6,17,31,18,0
5649,0,0,0,0,0,0,1,0.0,1,0,0,0,0,0,3,0
5650,6,2,5,1,0,5,9,55.6,4,7,5,2,7,13,37,0
5651,3,1,1,2,0,2,4,50.0,2,3,1,2,0,3,6,0
5652,12,5,7,4,1,8,12,66.7,4,5,1,4,7,19,9,1
5653,3,2,3,0,0,2,5,40.0,3,3,1,2,5,8,16,0
5654,5,4,2,3,0,1,7,14.3,6,2,0,2,2,7,5,0
5655,7,5,3,3,1,1,2,50.0,1,0,0,0,0,7,3,0
5656,8,3,2,6,0,3,6,50.0,3,5,1,4,3,11,1,0
5657,2,2,0,2,0,1,1,100.0,0,0,0,0,0,2,0,0
5658,4,4,1,3,0,3,5,60.0,2,4,1,3,0,4,3,0
5659,1,0,1,0,0,0,2,0.0,2,2,1,1,1,2,0,0
5660,0,0,0,0,0,0,0,0.0,0,0,0,0,0,0,0,0
5661,0,0,0,0,0,0,0,0.0,0,0,0,0,0,0,0,0
5662,22,16,17,4,1,12,16,75.0,4,23,17,6,11,33,134,0
5663,68,42,31,35,2,27,69,39.1,42,31,11,20,26,94,48,0
5664,56,33,35,18,3,26,58,44.8,32,26,7,19,29,85,55,0
5665,0,0,0,0,0,0,0,0.0,0,0,0,0,0,0,7,1
5666,9,7,3,5,1,2,11,18.2,9,15,1,14,3,12,17,0
5667,46,28,27,17,2,17,42,40.5,25,33,13,20,23,69,67,0
5668,39,27,18,16,5,17,44,38.6,27,25,10,15,25,64,27,0
5669,10,6,0,9,1,1,13,7.7,12,8,2,6,1,11,12,0
5670,38,25,17,14,7,16,29,55.2,13,14,3,11,32,70,49,0
5671,19,8,5,11,3,11,31,35.5,20,13,0,13,3,22,10,0
5672,14,9,9,5,0,9,14,64.3,5,17,12,5,17,31,75,0
5673,2,0,2,0,0,1,4,25.0,3,17,13,4,10,12,73,0
5674,27,21,18,7,2,13,28,46.4,15,16,2,14,18,45,31,0
5675,32,20,9,16,7,7,29,24.1,22,9,0,9,5,37,20,0
5676,20,15,6,11,3,5,9,55.6,4,7,3,4,4,24,4,0
5677,22,12,9,9,4,5,21,23.8,16,13,2,11,3,25,11,0
5678,19,11,8,11,0,9,19,47.4,10,13,4,9,12,31,47,0
5679,25,16,17,5,3,14,27,51.9,13,16,7,9,8,33,24,0
5680,1,1,1,0,0,1,1,100.0,0,0,0,0,0,1,5,0
5681,14,9,9,4,1,6,11,54.5,5,7,0,7,3,17,3,0
5682,8,6,4,3,1,2,6,33.3,4,5,2,3,2,10,1,0
5683,4,4,1,2,1,2,4,50.0,2,3,0,3,3,7,1,0
5684,7,3,4,3,0,2,9,22.2,7,6,2,4,1,8,4,1
5685,7,5,4,3,0,2,2,100.0,0,2,2,0,1,8,3,0
5686,3,2,3,0,0,2,4,50.0,2,1,0,1,1,4,2,0
5687,2,1,2,0,0,1,4,25.0,3,2,0,2,1,3,6,0
5688,0,0,0,0,0,0,0,0.0,0,0,0,0,1,1,0,0
5689,0,0,0,0,0,0,2,0.0,2,1,0,1,0,0,1,0
5690,1,1,0,1,0,1,1,100.0,0,0,0,0,0,1,0,0
5691,0,0,0,0,0,0,0,0.0,0,0,0,0,0,0,0,0
5692,0,0,0,0,0,0,0,0.0,0,0,0,0,0,0,0,0
5693,1,0,1,0,0,0,0,0.0,0,0,0,0,0,1,1,0
5694,54,34,38,16,0,27,34,79.4,7,22,11,11,50,104,109,0
5695,50,36,26,18,6,32,52,61.5,20,31,10,21,23,73,41,0
5696,23,13,12,9,2,14,30,46.7,16,21,15,6,23,46,112,0
5697,26,20,10,13,3,10,32,31.3,22,16,1,15,2,28,6,0
5698,44,26,14,23,7,15,37,40.5,22,31,4,27,2,46,27,0
5699,86,48,44,39,3,47,93,50.5,46,34,3,31,29,115,34,0
5700,28,18,16,10,2,17,28,60.7,11,22,0,22,15,43,19,0
5701,30,17,17,12,1,11,27,40.7,16,19,3,16,25,55,14,0
5702,0,0,0,0,0,0,0,0.0,0,0,0,0,0,0,6,1
5703,7,4,3,2,2,4,15,26.7,11,8,1,7,3,10,3,0
5704,24,15,10,13,1,15,24,62.5,9,15,7,8,18,42,50,0
5705,26,18,9,13,4,16,25,64.0,9,12,2,10,12,38,13,0
5706,30,19,14,14,2,18,33,54.5,15,21,3,18,14,44,26,0
5707,0,0,0,0,0,0,0,0.0,0,0,0,0,0,0,3,2
5708,28,20,17,9,2,20,30,66.7,10,4,3,1,10,38,43,0
5709,14,9,5,5,4,7,23,30.4,16,12,1,11,3,17,5,0
5710,17,10,7,8,2,5,17,29.4,12,9,4,5,4,21,7,0
5711,7,2,6,1,0,1,7,14.3,6,3,1,2,0,7,7,0
5712,4,3,0,4,0,0,2,0.0,2,4,3,1,2,6,5,0
5713,21,14,15,5,1,12,22,54.5,10,7,1,6,5,26,22,0
5714,12,5,1,10,1,6,11,54.5,5,5,0,5,0,12,5,0
5715,8,5,1,6,1,6,10,60.0,4,8,1,7,3,11,4,0
5716,9,5,3,3,3,3,7,42.9,4,6,0,6,3,12,0,0
5717,5,3,3,2,0,3,8,37.5,5,4,2,2,7,12,10,0
5718,3,2,1,2,0,1,3,33.3,2,0,0,0,0,3,2,0
5719,2,1,1,1,0,2,5,40.0,3,1,1,0,0,2,1,0
5720,5,3,2,3,0,0,4,0.0,4,5,0,5,1,6,0,0
5721,0,0,0,0,0,0,0,0.0,0,0,0,0,1,1,0,0
5722,0,0,0,0,0,0,0,0.0,0,0,0,0,1,1,1,0
5723,0,0,0,0,0,0,2,0.0,2,0,0,0,0,0,10,0
5724,37,26,12,19,6,20,47,42.6,27,39,2,37,13,50,7,0
5725,40,22,16,19,5,18,39,46.2,21,23,4,19,18,58,25,0
5726,68,53,24,37,7,38,69,55.1,31,34,5,29,42,110,29,0
5727,41,28,28,13,0,25,42,59.5,17,23,15,8,25,66,112,0
5728,52,37,26,23,3,23,40,57.5,17,27,4,23,29,81,59,1
5729,40,26,15,24,1,17,58,29.3,41,38,3,35,24,64,26,0
5730,67,42,37,28,2,32,55,58.2,23,22,2,20,27,94,47,0
5731,36,27,3,24,9,9,24,37.5,15,26,2,24,3,39,13,0
5732,20,11,14,5,1,10,18,55.6,8,20,8,12,15,35,56,1
5733,26,19,15,10,1,19,29,65.5,10,17,10,7,15,41,69,0
5734,29,16,8,12,9,13,31,41.9,18,20,2,18,6,35,26,0
5735,6,3,1,2,3,2,8,25.0,6,8,1,7,0,6,11,0
5736,7,5,0,4,3,2,16,12.5,14,13,3,10,6,13,10,0
5737,23,11,14,7,2,19,38,50.0,19,4,1,3,13,36,26,0
5738,10,4,4,1,5,5,11,45.5,6,7,1,6,5,15,5,0
5739,14,11,7,7,0,8,16,50.0,8,9,0,9,13,27,18,0
5740,14,9,10,4,0,6,10,60.0,4,8,5,3,8,22,16,1
5741,6,3,2,4,0,4,5,80.0,1,0,0,0,3,9,8,0
5742,2,2,1,1,0,0,0,0.0,0,1,0,1,0,2,1,0
5743,9,7,1,6,2,5,11,45.5,6,6,3,3,4,13,3,0
5744,2,0,0,1,1,1,2,50.0,1,3,1,2,1,3,2,0
5745,0,0,0,0,0,0,1,0.0,1,0,0,0,0,0,0,0
5746,3,1,1,0,2,1,2,50.0,1,0,0,0,2,5,0,0
5747,10,4,3,5,2,3,7,42.9,4,2,1,1,4,14,0,0
5748,2,1,0,1,1,0,2,0.0,2,6,0,6,0,2,1,0
5749,2,2,0,2,0,0,3,0.0,3,0,0,0,0,2,0,0
5750,1,0,0,1,0,0,1,0.0,1,0,0,0,0,1,0,0
5751,1,1,1,0,0,1,1,100.0,0,1,0,1,1,2,11,0
5752,28,18,22,6,0,18,34,52.9,16,22,16,6,30,58,129,1
5753,30,24,24,6,0,19,30,63.3,11,33,25,8,40,70,120,1
5754,66,54,35,27,4,31,64,48.4,33,27,4,23,17,83,20,0
5755,69,47,37,28,4,35,52,67.3,17,20,5,15,37,106,41,0
5756,24,15,7,14,3,12,21,57.1,9,34,8,26,9,33,27,0
5757,20,11,6,10,4,10,35,28.6,25,14,0,14,12,32,9,0
5758,20,10,1,10,9,4,12,33.3,8,15,2,13,0,20,10,0
5759,30,22,23,4,3,14,31,45.2,17,17,4,13,14,44,35,0
5760,10,4,2,5,3,2,8,25.0,6,17,1,16,1,11,5,0
5761,29,20,20,8,1,18,30,60.0,12,4,0,4,9,38,37,0
5762,23,16,6,14,3,13,28,46.4,15,9,3,6,18,41,25,0
5763,16,12,8,5,3,8,15,53.3,7,14,4,10,16,32,28,1
5764,24,14,6,13,5,8,21,38.1,13,8,0,8,4,28,9,0
5765,11,7,7,4,0,9,21,42.9,12,9,2,7,13,24,16,0
5766,32,22,13,16,3,8,23,34.8,15,8,1,7,11,43,10,1
5767,16,8,5,8,3,8,14,57.1,6,9,1,8,6,22,3,0
5768,7,5,2,4,1,3,9,33.3,6,8,1,7,2,9,5,0
5769,7,5,2,3,2,4,9,44.4,5,12,0,12,5,12,2,0
5770,20,9,10,8,2,10,23,43.5,13,11,3,8,3,23,13,0
5771,7,4,1,4,2,4,6,66.7,2,7,2,5,1,8,5,0
5772,10,5,3,5,2,5,13,38.5,8,3,0,3,0,10,3,0
5773,8,4,1,7,0,3,7,42.9,4,4,0,4,6,14,3,0
5774,10,6,6,4,0,6,11,54.5,5,2,0,2,5,15,27,0
5775,5,4,3,2,0,5,5,100.0,0,2,1,1,4,9,11,0
5776,4,2,1,3,0,4,5,80.0,1,1,0,1,0,4,5,0
5777,7,3,2,4,1,2,6,33.3,4,1,0,1,2,9,4,0
5778,2,2,1,1,0,1,3,33.3,2,4,3,1,4,6,6,0
5779,0,0,0,0,0,0,0,0.0,0,0,0,0,0,0,1,0
5780,4,4,2,2,0,1,1,100.0,0,0,0,0,1,5,1,0
5781,4,1,3,1,0,2,3,66.7,1,1,0,1,2,6,5,0
5782,2,2,2,0,0,2,3,66.7,1,3,1,2,2,4,0,0
5783,2,1,0,1,1,1,2,50.0,1,0,0,0,1,3,0,0
5784,3,0,0,1,2,1,1,100.0,0,0,0,0,0,3,0,0
5785,0,0,0,0,0,0,1,0.0,1,0,0,0,0,0,0,0
5786,40,22,31,9,0,26,43,60.5,17,40,33,7,24,64,166,0
5787,37,22,25,11,1,21,44,47.7,23,24,9,15,29,66,63,0
5788,78,46,29,41,8,43,105,41.0,62,36,17,19,45,123,45,0
5789,57,35,41,14,2,27,50,54.0,23,46,16,30,47,104,113,0
5790,21,14,5,16,0,5,28,17.9,23,12,0,12,5,26,6,0
5791,38,30,24,11,3,21,50,42.0,29,20,2,18,19,57,38,0
5792,40,21,13,22,5,14,43,32.6,29,24,4,20,19,59,29,0
5793,16,10,3,12,1,5,16,31.3,11,12,1,11,1,17,0,0
5794,24,15,8,14,2,7,18,38.9,11,19,0,19,9,33,3,0
5795,0,0,0,0,0,0,1,0.0,1,0,0,0,1,1,7,2
5796,24,15,13,11,0,11,17,64.7,6,17,10,7,7,31,59,0
5797,26,13,13,11,2,11,30,36.7,19,11,1,10,26,52,45,1
5798,15,10,3,6,6,8,10,80.0,2,10,1,9,1,16,12,0
5799,0,0,0,0,0,0,1,0.0,1,0,0,0,0,0,3,0
5800,22,13,9,10,3,12,18,66.7,6,5,2,3,13,35,25,1
5801,14,9,6,7,1,7,21,33.3,14,8,0,8,1,15,7,0
5802,18,11,7,10,1,9,25,36.0,16,9,1,8,5,23,9,0
5803,9,5,4,5,0,4,12,33.3,8,9,2,7,7,16,13,0
5804,10,8,4,5,1,7,11,63.6,4,6,2,4,3,13,10,0
5805,8,5,3,3,2,6,7,85.7,1,3,1,2,1,9,3,0
5806,1,0,0,0,1,1,4,25.0,3,1,0,1,1,2,0,0
5807,3,3,1,2,0,2,4,50.0,2,2,0,2,0,3,0,0
5808,2,1,1,1,0,1,1,100.0,0,0,0,0,0,2,2,0
5809,1,1,1,0,0,1,1,100.0,0,0,0,0,1,2,0,0
5810,6,5,6,0,0,1,3,33.3,2,1,0,1,1,7,2,0
5811,0,0,0,0,0,0,1,0.0,1,1,0,1,0,0,0,0
5812,1,1,1,0,0,1,1,100.0,0,0,0,0,1,2,8,0
5813,71,45,34,29,8,32,75,42.7,43,35,4,31,48,119,52,0
5814,10,8,1,6,3,3,16,18.8,13,9,4,5,7,17,18,0
5815,33,18,22,9,2,16,22,72.7,6,19,11,8,34,67,96,0
5816,40,26,21,18,1,20,44,45.5,24,27,8,19,19,59,27,0
5817,71,50,34,32,5,23,56,41.1,33,24,3,21,19,90,34,0
5818,13,8,1,6,6,6,11,54.5,5,21,1,20,6,19,20,0
5819,66,41,18,37,11,30,60,50.0,30,36,5,31,16,82,15,0
5820,22,17,13,9,0,14,22,63.6,8,22,9,13,22,44,53,3
5821,16,8,5,8,3,10,21,47.6,11,16,1,15,4,20,10,0
5822,23,16,14,9,0,10,15,66.7,5,16,11,5,22,45,51,2
5823,18,11,7,9,2,5,24,20.8,19,11,0,11,10,28,9,0
5824,20,14,12,6,2,11,15,73.3,4,6,3,3,10,30,15,0
5825,17,12,13,4,0,9,15,60.0,6,10,2,8,23,40,46,1
5826,16,14,7,5,4,7,14,50.0,7,17,2,15,8,24,8,0
5827,19,14,6,12,1,12,24,50.0,12,12,2,10,6,25,3,0
5828,13,10,3,9,1,3,12,25.0,9,5,0,5,6,19,12,0
5829,8,5,0,7,1,3,8,37.5,5,7,0,7,2,10,2,0
5830,10,5,4,6,0,5,9,55.6,4,10,3,7,7,17,14,0
5831,9,5,3,5,1,6,15,40.0,9,4,0,4,9,18,9,0
5832,6,6,4,1,1,4,10,40.0,6,0,0,0,3,9,2,0
5833,4,1,2,2,0,1,3,33.3,2,3,1,2,0,4,2,0
5834,8,5,1,4,3,5,8,62.5,3,4,0,4,2,10,3,1
5835,10,5,5,3,2,6,10,60.0,4,3,1,2,0,10,1,0
5836,2,1,0,1,1,1,2,50.0,1,0,0,0,0,2,1,0
5837,5,3,1,4,0,2,8,25.0,6,4,0,4,2,7,1,0
5838,3,2,2,1,0,2,5,40.0,3,2,0,2,0,3,0,0
5839,7,6,4,3,0,6,6,100.0,0,2,0,2,1,8,2,0
5840,0,0,0,0,0,0,0,0.0,0,1,0,1,0,0,1,0
5841,0,0,0,0,0,0,0,0.0,0,0,0,0,0,0,0,0
5842,58,38,36,18,4,31,53,58.5,22,29,5,24,26,84,55,1
5843,34,22,27,7,0,19,29,65.5,10,27,16,11,45,79,97,0
5844,0,0,0,0,0,0,1,0.0,1,0,0,0,1,1,3,0
5845,37,24,18,16,3,20,60,33.3,40,27,3,24,33,70,24,0
5846,49,30,31,17,1,27,47,57.4,20,19,5,14,21,70,38,0
5847,12,8,2,7,3,3,9,33.3,6,18,1,17,1,13,7,0
5848,23,13,17,6,0,14,21,66.7,7,16,10,6,22,45,49,0
5849,8,5,1,6,1,1,19,5.3,18,12,4,8,7,15,10,0
5850,18,11,5,8,5,5,16,31.3,11,18,2,16,2,20,30,1
5851,26,18,11,14,1,17,37,45.9,20,28,6,22,18,44,15,0
5852,13,10,3,9,1,7,25,28.0,18,20,2,18,13,26,3,0
5853,25,17,20,4,1,10,14,71.4,4,13,10,3,28,53,49,0
5854,25,15,16,9,0,14,24,58.3,10,13,5,8,20,45,46,0
5855,26,14,6,16,4,9,22,40.9,13,16,3,13,5,31,7,0
5856,22,14,5,13,4,5,24,20.8,19,19,1,18,6,28,5,0
5857,26,17,7,18,1,12,22,54.5,10,8,0,8,3,29,14,0
5858,0,0,0,0,0,0,2,0.0,2,0,0,0,0,0,3,0
5859,26,20,20,6,0,20,27,74.1,7,8,2,6,10,36,18,0
5860,22,12,7,12,3,10,20,50.0,10,10,2,8,6,28,22,0
5861,12,7,4,6,2,8,20,40.0,12,9,1,8,6,18,5,1
5862,15,10,5,8,2,7,14,50.0,7,10,0,10,5,20,15,0
5863,9,3,1,6,2,4,16,25.0,12,6,0,6,1,10,13,0
5864,13,10,5,7,1,10,25,40.0,15,12,2,10,12,25,6,0
5865,10,6,1,8,1,6,12,50.0,6,11,1,10,8,18,8,0
5866,7,5,4,2,1,4,12,33.3,8,4,0,4,3,10,0,0
5867,3,1,2,0,1,2,4,50.0,2,4,0,4,0,3,3,0
5868,1,1,1,0,0,0,1,0.0,1,2,0,2,0,1,2,0
5869,2,1,2,0,0,2,2,100.0,0,0,0,0,2,4,10,0
5870,64,43,27,31,6,32,70,45.7,38,31,4,27,57,121,32,0
5871,60,36,28,27,5,26,54,48.1,28,32,5,27,26,86,48,1
5872,17,10,1,5,11,7,21,33.3,14,9,0,9,4,21,10,0
5873,25,11,20,5,0,13,18,72.2,5,14,9,5,24,49,75,0
5874,52,38,27,19,6,28,46,60.9,18,21,5,16,24,76,41,0
5875,35,20,14,20,1,22,37,59.5,15,20,4,16,30,65,28,0
5876,25,18,10,10,5,12,33,36.4,21,16,0,16,8,33,4,0
5877,17,7,9,8,0,11,21,52.4,10,16,8,8,21,38,54,1
5878,15,9,2,5,8,4,16,25.0,12,12,2,10,0,15,15,0
5879,18,11,7,8,3,6,29,20.7,23,35,2,33,6,24,2,0
5880,15,8,4,8,3,6,21,28.6,15,12,0,12,5,20,1,0
5881,26,14,13,8,5,11,23,47.8,12,16,3,13,12,38,6,0
5882,8,6,4,4,0,5,9,55.6,4,8,5,3,15,23,32,0
5883,7,6,4,3,0,6,15,40.0,9,8,2,6,3,10,20,0
5884,12,4,5,7,0,5,15,33.3,10,9,4,5,10,22,12,0
5885,21,11,3,13,5,7,23,30.4,16,11,1,10,5,26,4,0
5886,11,9,2,7,2,7,13,53.8,6,5,0,5,5,16,4,0
5887,24,17,21,3,0,13,17,76.5,4,8,1,7,7,31,20,0
5888,9,6,6,3,0,6,14,42.9,8,3,2,1,9,18,32,0
5889,12,8,2,7,3,2,4,50.0,2,8,0,8,0,12,6,0
5890,16,14,12,3,1,11,17,64.7,6,7,0,7,4,20,8,0
5891,6,4,2,4,0,2,9,22.2,7,3,2,1,10,16,8,0
5892,9,6,1,8,0,5,10,50.0,5,6,0,6,8,17,2,0
5893,9,6,2,7,0,7,11,63.6,4,0,0,0,1,10,1,0
5894,0,0,0,0,0,0,0,0.0,0,0,0,0,0,0,3,1
5895,2,1,1,1,0,1,5,20.0,4,1,0,1,1,3,1,0
5896,1,1,1,0,0,1,2,50.0,1,2,2,0,0,1,7,0
5897,3,2,0,2,1,0,0,0.0,0,1,0,1,2,5,0,0
5898,0,0,0,0,0,0,1,0.0,1,3,0,3,0,0,0,0
5899,1,1,1,0,0,1,2,50.0,1,0,0,0,0,1,11,1
5900,60,36,35,25,0,33,52,63.5,19,44,17,27,31,91,110,0
5901,58,32,12,28,18,21,57,36.8,36,39,2,37,8,66,15,0
5902,33,17,24,8,1,18,33,54.5,15,30,13,17,26,59,102,0
5903,49,30,34,11,4,25,55,45.5,30,19,3,16,33,82,20,0
5904,47,28,14,30,3,21,50,42.0,29,24,9,15,22,69,30,0
5905,45,26,25,17,3,27,49,55.1,22,43,11,32,22,67,64,1
5906,4,4,0,2,2,2,7,28.6,5,8,3,5,5,9,7,0
5907,19,11,8,6,5,13,38,34.2,25,21,1,20,19,38,13,0
5908,16,10,12,4,0,10,18,55.6,8,18,6,12,17,33,69,1
5909,18,10,5,11,2,7,28,25.0,21,12,0,12,5,23,2,0
5910,25,15,11,10,4,13,25,52.0,12,16,2,14,17,42,14,0
5911,38,24,21,16,1,19,34,55.9,15,21,3,18,15,53,12,1
5912,20,9,4,14,2,13,25,52.0,12,16,3,13,18,38,8,0
5913,10,7,2,6,2,2,14,14.3,12,8,1,7,2,12,10,0
5914,33,20,13,13,7,18,32,56.3,14,20,3,17,12,45,12,0
5915,10,9,8,2,0,7,13,53.8,6,3,0,3,7,17,11,0
5916,2,1,0,2,0,0,4,0.0,4,3,0,3,1,3,0,0
5917,6,5,3,3,0,4,9,44.4,5,9,0,9,1,7,7,1
5918,8,7,3,5,0,3,12,25.0,9,9,1,8,3,11,1,0
5919,4,4,1,2,1,2,2,100.0,0,0,0,0,0,4,0,0
5920,3,2,2,1,0,1,6,16.7,5,4,0,4,7,10,13,0
5921,4,3,4,0,0,2,4,50.0,2,3,3,0,0,4,23,1
5922,11,8,1,9,1,6,14,42.9,8,5,1,4,1,12,3,0
5923,1,1,1,0,0,0,0,0.0,0,0,0,0,2,3,2,0
5924,1,1,1,0,0,0,1,0.0,1,0,0,0,0,1,1,0
5925,1,1,0,0,1,1,1,100.0,0,0,0,0,0,1,0,0
5926,1,1,0,1,0,0,1,0.0,1,2,0,2,0,1,0,0
5927,1,1,1,0,0,1,1,100.0,0,1,1,0,0,1,11,4
5928,62,35,34,20,8,31,58,53.4,27,38,7,31,34,96,54,0
5929,36,29,18,17,1,13,48,27.1,35,32,9,23,25,61,42,1
5930,23,12,13,6,4,9,41,22.0,32,18,2,16,12,35,8,0
5931,53,38,29,17,7,29,39,74.4,10,18,4,14,19,72,64,0
5932,44,28,36,8,0,22,44,50.0,22,23,9,14,41,85,85,0
5933,26,18,18,8,0,19,29,65.5,10,32,15,17,26,52,118,2
5934,15,9,3,10,2,2,20,10.0,18,12,1,11,6,21,5,0
5935,43,22,30,11,2,23,45,51.1,22,29,13,16,12,55,50,0
5936,13,9,2,8,3,2,17,11.8,15,14,0,14,3,16,17,0
5937,35,22,22,11,2,16,37,43.2,21,21,5,16,17,52,21,0
5938,34,24,7,26,1,6,28,21.4,22,20,4,16,11,45,9,0
5939,17,8,10,4,3,6,13,46.2,7,15,0,15,7,24,9,0
5940,7,5,3,2,2,0,8,0.0,8,10,1,9,1,8,12,0
5941,25,10,9,14,2,13,35,37.1,22,10,4,6,13,38,3,0
5942,1,1,0,0,1,0,4,0.0,4,8,4,4,0,1,13,0
5943,19,10,14,4,1,9,15,60.0,6,8,4,4,13,32,45,0
5944,15,9,10,5,0,8,15,53.3,7,9,2,7,7,22,33,1
5945,9,4,3,4,2,7,13,53.8,6,6,1,5,1,10,0,0
5946,4,3,1,1,2,2,5,40.0,3,3,0,3,3,7,7,0
5947,5,3,0,3,2,3,4,75.0,1,0,0,0,1,6,2,0
5948,5,3,1,3,1,3,5,60.0,2,8,1,7,0,5,0,0
5949,2,1,2,0,0,0,2,0.0,2,1,1,0,1,3,3,0
5950,6,4,2,4,0,4,6,66.7,2,1,0,1,1,7,0,0
5951,1,1,0,1,0,0,3,0.0,3,2,0,2,0,1,0,0
5952,0,0,0,0,0,0,0,0.0,0,1,0,1,0,0,0,0
5953,0,0,0,0,0,0,0,0.0,0,0,0,0,0,0,0,0
5954,0,0,0,0,0,0,0,0.0,0,0,0,0,0,0,0,0
5955,7,4,0,5,2,2,6,33.3,4,13,0,13,1,8,1,0
5956,6,4,2,3,1,0,4,0.0,4,5,0,5,3,9,4,0
5957,3,1,2,0,1,2,4,50.0,2,2,0,2,1,4,5,0
5958,30,21,14,11,5,7,19,36.8,12,20,5,15,14,44,31,0
5959,30,20,18,10,2,11,13,84.6,2,20,9,11,20,50,75,0
5960,20,16,7,10,3,9,16,56.3,7,5,2,3,6,26,21,0
5961,4,3,3,1,0,1,19,5.3,18,17,1,16,4,8,7,0
5962,15,9,7,6,2,2,6,33.3,4,8,2,6,5,20,3,0
5963,15,8,7,8,0,12,20,60.0,8,14,2,12,13,28,24,0
5964,8,6,5,3,0,5,8,62.5,3,14,5,9,5,13,15,0
5965,33,19,15,15,3,18,37,48.6,19,22,8,14,27,60,37,0
5966,27,18,12,12,3,15,26,57.7,11,12,5,7,12,39,20,0
5967,4,2,2,1,1,3,3,100.0,0,2,1,1,4,8,3,0
5968,3,2,2,1,0,2,2,100.0,0,0,0,0,1,4,4,0
5969,11,5,2,4,5,2,3,66.7,1,10,2,8,6,17,7,2
5970,17,7,7,8,2,4,12,33.3,8,9,0,9,4,21,5,0
5971,27,16,17,10,0,14,24,58.3,10,30,19,11,31,58,105,1
5972,1,0,0,0,1,0,0,0.0,0,0,0,0,0,1,1,0
5973,45,31,19,22,4,26,44,59.1,18,18,2,16,27,72,24,1
5974,59,43,44,14,1,26,50,52.0,24,64,42,22,42,101,165,3
5975,28,19,17,9,2,15,29,51.7,14,11,0,11,9,37,4,0
5976,17,13,5,10,2,8,17,47.1,9,9,1,8,11,28,7,0
5977,29,19,15,10,4,18,25,72.0,7,24,1,23,13,42,26,0
5978,61,42,33,16,12,27,51,52.9,24,40,7,33,20,81,39,0
5979,29,20,11,14,4,13,23,56.5,10,12,0,12,9,38,6,0
5980,85,55,49,25,11,54,100,54.0,46,54,4,50,35,120,73,0
5981,4,3,0,2,2,1,2,50.0,1,2,0,2,2,6,0,0
5982,9,6,4,4,1,3,7,42.9,4,6,1,5,7,16,6,0
5983,0,0,0,0,0,0,0,0.0,0,1,1,0,0,0,2,1
5984,27,16,19,8,0,15,23,65.2,8,18,9,9,20,47,55,0
5985,0,0,0,0,0,0,0,0.0,0,0,0,0,0,0,1,0
5986,19,13,15,4,0,8,16,50.0,8,5,2,3,1,20,5,0
5987,12,11,10,1,1,8,16,50.0,8,12,1,11,5,17,3,0
5988,11,7,3,7,1,4,28,14.3,24,19,2,17,9,20,13,0
5989,25,16,8,8,9,13,28,46.4,15,30,3,27,9,34,23,0
5990,7,4,1,6,0,0,2,0.0,2,5,0,5,1,8,3,0
5991,21,11,15,6,0,13,23,56.5,10,10,4,6,17,38,24,1
5992,8,3,4,4,0,2,6,33.3,4,0,0,0,5,13,0,0
5993,15,11,6,9,0,6,19,31.6,13,11,3,8,11,26,8,1
5994,6,5,1,4,1,0,6,0.0,6,13,1,12,3,9,14,0
5995,29,15,16,10,3,17,33,51.5,16,17,4,13,12,41,22,0
5996,1,1,0,1,0,1,2,50.0,1,0,0,0,0,1,0,0
5997,1,0,1,0,0,0,0,0.0,0,1,0,1,0,1,0,1
5998,48,34,18,23,7,22,44,50.0,22,39,18,21,34,82,44,1
5999,14,9,8,5,1,8,14,57.1,6,15,5,10,9,23,14,0
6000,60,36,27,21,12,26,66,39.4,40,30,6,24,32,92,17,1
6001,94,59,34,42,18,46,71,64.8,25,50,9,41,35,129,19,0
6002,0,0,0,0,0,0,3,0.0,3,1,0,1,0,0,2,0
6003,13,8,3,6,4,6,22,27.3,16,21,2,19,12,25,17,0
6004,0,0,0,0,0,0,3,0.0,3,0,0,0,0,0,0,0
6005,25,16,7,9,9,9,25,36.0,16,11,0,11,10,35,6,0
6006,39,24,27,11,1,23,37,62.2,14,40,23,17,32,71,116,2
6007,14,6,3,8,3,5,16,31.3,11,10,1,9,7,21,21,0
6008,53,34,34,16,3,29,47,61.7,18,38,25,13,35,88,102,1
6009,1,0,0,0,1,1,2,50.0,1,2,0,2,0,1,1,0
6010,17,11,2,10,5,8,18,44.4,10,19,0,19,15,32,23,0
6011,56,29,18,27,11,25,44,56.8,19,24,3,21,21,77,18,1
6012,0,0,0,0,0,0,2,0.0,2,0,0,0,0,0,13,1
6013,15,7,1,10,4,1,8,12.5,7,17,2,15,5,20,12,0
6014,7,2,4,3,0,2,7,28.6,5,6,0,6,2,9,2,0
6015,64,39,47,16,1,40,59,67.8,19,34,18,16,51,115,140,1
6016,55,33,35,14,6,25,46,54.3,21,20,3,17,22,77,44,0
6017,19,11,12,6,1,8,18,44.4,10,13,6,7,15,34,47,2
6018,27,21,18,7,2,16,29,55.2,13,27,2,25,29,56,56,1
6019,14,8,6,5,3,4,13,30.8,9,7,0,7,6,20,2,0
6020,1,0,1,0,0,1,2,50.0,1,4,3,1,5,6,8,0
6021,33,17,18,15,0,13,23,56.5,10,38,24,14,46,79,148,1
6022,53,36,16,26,11,27,70,38.6,43,34,3,31,18,71,20,0
6023,77,43,32,36,9,39,89,43.8,50,43,8,35,37,114,35,0
6024,24,18,15,8,1,13,24,54.2,11,21,9,12,20,44,64,1
6025,12,5,6,3,3,6,12,50.0,6,5,0,5,8,20,0,0
6026,5,3,1,4,0,1,4,25.0,3,7,1,6,2,7,3,0
6027,58,43,26,26,6,36,68,52.9,32,36,12,24,34,92,45,0
6028,52,33,31,17,4,34,56,60.7,22,27,6,21,24,76,44,0
6029,16,5,7,7,2,3,11,27.3,8,7,0,7,1,17,4,0
6030,55,43,22,28,5,28,48,58.3,20,19,11,8,16,71,32,0
6031,4,3,2,1,1,2,7,28.6,5,3,0,3,2,6,2,0
6032,12,7,8,4,0,5,7,71.4,2,18,11,7,14,26,71,0
6033,0,0,0,0,0,0,0,0.0,0,0,0,0,0,0,0,0
6034,98,58,36,49,13,34,97,35.1,63,33,3,30,44,142,11,0
6035,19,13,9,5,5,9,15,60.0,6,6,0,6,2,21,4,1
6036,0,0,0,0,0,0,0,0.0,0,1,0,1,0,0,0,0
6037,39,26,17,18,4,12,25,48.0,13,30,4,26,18,57,13,0
6038,25,19,21,4,0,11,17,64.7,6,36,28,8,11,36,61,1
6039,24,20,12,10,2,14,31,45.2,17,19,5,14,19,43,54,0
6040,55,33,37,17,1,29,34,85.3,5,46,31,15,72,127,156,1
6041,24,16,8,12,4,10,33,30.3,23,13,1,12,18,42,11,0
6042,34,16,10,21,3,20,37,54.1,17,23,5,18,11,45,22,1
6043,51,31,20,26,5,27,48,56.3,21,29,11,18,28,79,45,0
6044,8,2,2,5,1,3,7,42.9,4,3,2,1,4,12,5,1
6045,0,0,0,0,0,0,0,0.0,0,0,0,0,0,0,1,0
6046,10,9,6,3,1,4,7,57.1,3,7,1,6,6,16,13,0
6047,31,18,18,9,4,14,29,48.3,15,8,2,6,14,45,26,0
6048,0,0,0,0,0,0,0,0.0,0,0,0,0,0,0,0,0
6049,17,8,10,5,2,13,17,76.5,4,10,2,8,12,29,26,0
6050,60,41,29,23,8,35,53,66.0,18,43,16,27,41,101,80,0
6051,0,0,0,0,0,0,0,0.0,0,0,0,0,0,0,0,0
6052,2,2,1,1,0,1,2,50.0,1,2,0,2,0,2,1,0
6053,2,0,1,1,0,1,4,25.0,3,4,0,4,4,6,1,0
6054,76,49,35,30,11,40,81,49.4,41,53,14,39,54,130,56,3
6055,40,24,17,20,3,16,45,35.6,29,37,16,21,22,62,33,3
6056,2,2,1,1,0,1,5,20.0,4,0,0,0,1,3,3,0
6057,4,1,0,2,2,2,5,40.0,3,4,0,4,0,4,7,0
6058,23,16,10,11,2,14,33,42.4,19,17,1,16,4,27,7,0
6059,20,12,6,11,3,6,18,33.3,12,3,0,3,12,32,2,1
6060,94,54,44,39,11,52,90,57.8,38,23,6,17,25,119,45,1
6061,13,7,4,5,4,1,10,10.0,9,7,2,5,4,17,11,0
6062,2,1,1,1,0,1,4,25.0,3,9,4,5,3,5,3,0
6063,45,29,25,13,7,19,60,31.7,41,23,0,23,20,65,14,0
6064,1,1,1,0,0,1,1,100.0,0,0,0,0,3,4,6,0
6065,4,3,2,0,2,3,5,60.0,2,6,0,6,1,5,0,0
6066,20,9,10,7,3,6,15,40.0,9,5,0,5,3,23,8,0
6067,1,1,1,0,0,1,1,100.0,0,0,0,0,0,1,0,0
6068,18,8,6,8,4,7,30,23.3,23,13,2,11,22,40,5,0
6069,12,7,2,7,3,5,9,55.6,4,11,2,9,4,16,4,0
6070,2,1,1,1,0,2,2,100.0,0,1,1,0,0,2,0,0
6071,43,27,21,21,1,22,45,48.9,23,25,7,18,15,58,44,1
6072,0,0,0,0,0,0,1,0.0,1,1,0,1,0,0,0,0
6073,17,11,10,7,0,13,19,68.4,6,16,2,14,8,25,14,0
6074,5,3,1,3,1,3,4,75.0,1,3,2,1,1,6,2,0
6075,25,15,6,14,5,6,17,35.3,11,15,1,14,7,32,25,1
6076,3,1,2,1,0,2,3,66.7,1,6,4,2,2,5,9,0
6077,83,47,38,37,8,43,70,61.4,27,48,13,35,43,126,46,0
6078,1,1,0,1,0,1,1,100.0,0,1,1,0,0,1,1,0
6079,9,3,4,4,1,5,8,62.5,3,8,3,5,11,20,5,0
6080,0,0,0,0,0,0,0,0.0,0,0,0,0,0,0,0,0
6081,79,45,33,36,10,43,86,50.0,43,66,16,50,44,123,76,1
6082,15,7,8,6,1,8,15,53.3,7,15,4,11,6,21,12,0
6083,5,2,4,0,1,2,5,40.0,3,4,2,2,5,10,12,0
6084,28,13,15,10,3,9,26,34.6,17,15,3,12,7,35,16,0
6085,28,19,10,17,1,14,30,46.7,16,24,10,14,26,54,21,0
6086,41,19,17,20,4,22,54,40.7,32,15,4,11,16,57,29,1
6087,74,52,49,17,8,45,72,62.5,27,35,9,26,54,128,77,1
6088,0,0,0,0,0,0,0,0.0,0,0,0,0,0,0,0,0
6089,70,48,31,32,7,28,55,50.9,27,23,1,22,14,84,5,0
6090,29,17,7,21,1,11,21,52.4,10,15,8,7,8,37,11,0
6091,36,22,18,12,6,16,49,32.7,33,25,8,17,23,59,19,1
6092,4,1,1,3,0,3,3,100.0,0,1,0,1,0,4,0,0
6093,1,0,1,0,0,1,1,100.0,0,3,1,2,1,2,3,0
6094,0,0,0,0,0,0,1,0.0,1,0,0,0,1,1,0,0
6095,55,31,33,19,3,28,40,70.0,12,24,14,10,55,110,138,0
6096,0,0,0,0,0,0,0,0.0,0,0,0,0,0,0,0,0
6097,15,9,9,5,1,6,9,66.7,3,11,7,4,13,28,23,0
6098,3,2,2,1,0,2,6,33.3,4,1,0,1,1,4,0,0
6099,16,8,5,5,6,6,17,35.3,11,14,1,13,6,22,5,0
6100,7,6,5,2,0,6,12,50.0,6,4,3,1,4,11,11,0
6101,11,8,10,0,1,7,9,77.8,2,6,0,6,7,18,8,0
6102,34,27,18,13,3,15,34,44.1,19,29,1,28,15,49,13,1
6103,0,0,0,0,0,0,0,0.0,0,0,0,0,1,1,0,0
6104,49,32,21,21,7,13,32,40.6,19,27,3,24,17,66,6,0
6105,1,1,1,0,0,0,0,0.0,0,0,0,0,0,1,1,0
6106,7,4,4,3,0,0,3,0.0,3,4,2,2,6,13,13,1
6107,61,39,42,19,0,36,60,60.0,24,38,20,18,38,99,190,0
6108,21,12,7,8,6,11,23,47.8,12,17,0,17,5,26,5,0
6109,1,1,0,1,0,1,2,50.0,1,2,1,1,3,4,3,0
6110,59,30,20,32,7,20,36,55.6,16,32,12,20,33,92,41,1
6111,51,35,26,19,6,23,48,47.9,25,44,10,34,31,82,35,0
6112,25,14,19,5,1,13,18,72.2,5,31,23,8,15,40,63,0
6113,28,14,18,8,2,13,28,46.4,15,33,12,21,34,62,95,0
6114,14,8,10,4,0,6,10,60.0,4,9,4,5,9,23,26,0
6115,25,13,15,8,2,15,22,68.2,7,34,26,8,25,50,98,1
6116,3,1,1,2,0,0,1,0.0,1,0,0,0,0,3,4,0
6117,24,19,11,9,4,13,22,59.1,9,13,3,10,18,42,61,0
6118,13,8,4,6,3,6,17,35.3,11,19,6,13,4,17,20,0
6119,7,6,5,2,0,1,4,25.0,3,7,2,5,5,12,6,0
6120,45,29,33,12,0,18,21,85.7,3,40,27,13,54,99,106,5
6121,0,0,0,0,0,0,1,0.0,1,0,0,0,0,0,23,2
6122,7,5,3,2,2,4,5,80.0,1,2,1,1,2,9,2,0
6123,34,19,25,6,3,13,19,68.4,6,37,21,16,18,52,61,0
6124,26,18,16,8,2,12,23,52.2,11,18,9,9,20,46,72,0
6125,48,31,27,15,6,35,56,62.5,21,31,8,23,40,88,71,0
6126,38,20,16,17,5,14,32,43.8,18,24,5,19,16,54,16,0
6127,81,55,34,40,7,25,55,45.5,30,39,10,29,33,114,53,1
6128,7,4,5,2,0,2,2,100.0,0,2,2,0,4,11,8,1
6129,6,4,2,3,1,3,7,42.9,4,8,2,6,2,8,10,1
6130,37,24,19,14,4,21,29,72.4,8,31,4,27,17,54,29,1
6131,9,5,5,4,0,6,14,42.9,8,9,2,7,4,13,13,0
6132,48,25,28,15,5,22,59,37.3,37,42,6,36,28,76,43,0
6133,0,0,0,0,0,0,0,0.0,0,0,0,0,0,0,0,0
6134,10,5,5,4,1,4,7,57.1,3,4,2,2,10,20,6,0
6135,9,6,6,3,0,3,6,50.0,3,7,1,6,5,14,12,0
6136,1,0,1,0,0,1,1,100.0,0,0,0,0,0,1,3,0
6137,1,1,1,0,0,1,4,25.0,3,6,5,1,8,9,9,0
6138,5,2,1,2,2,3,5,60.0,2,6,1,5,6,11,10,0
6139,43,26,19,17,7,24,51,47.1,27,25,5,20,27,70,19,1
6140,0,0,0,0,0,0,0,0.0,0,0,0,0,1,1,2,0
6141,1,1,0,1,0,1,1,100.0,0,0,0,0,1,2,0,0
6142,59,34,29,20,10,34,61,55.7,27,49,24,25,31,90,40,0
6143,46,19,15,26,5,17,54,31.5,37,37,5,32,22,68,25,0
6144,0,0,0,0,0,0,0,0.0,0,0,0,0,0,0,29,3
6145,53,36,37,13,3,25,44,56.8,19,24,12,12,31,84,66,0
6146,43,29,25,13,5,23,44,52.3,21,34,12,22,34,77,47,3
6147,8,4,2,5,1,3,6,50.0,3,4,0,4,4,12,4,0
6148,18,11,7,9,2,7,18,38.9,11,5,0,5,6,24,8,0
6149,53,38,24,22,7,33,59,55.9,26,25,5,20,23,76,51,1
6150,12,7,5,5,2,4,12,33.3,8,7,1,6,1,13,13,0
6151,0,0,0,0,0,0,0,0.0,0,0,0,0,0,0,0,0
6152,7,5,3,1,3,2,4,50.0,2,2,0,2,4,11,3,0
6153,33,20,18,10,5,19,23,82.6,4,14,7,7,10,43,49,0
6154,7,5,4,3,0,2,8,25.0,6,10,4,6,2,9,8,0
6155,37,24,25,9,3,20,47,42.6,27,27,17,10,27,64,69,2
6156,47,34,33,13,1,32,59,54.2,27,43,15,28,29,76,90,1
6157,14,9,4,7,3,6,11,54.5,5,24,6,18,4,18,9,0
6158,3,3,1,2,0,2,2,100.0,0,3,0,3,0,3,2,0
6159,30,18,18,8,4,21,44,47.7,23,13,2,11,17,47,42,1
6160,11,5,1,3,7,4,10,40.0,6,9,2,7,6,17,28,0
6161,60,33,21,32,7,34,73,46.6,39,29,2,27,23,83,15,1
6162,14,11,7,6,1,6,24,25.0,18,19,1,18,12,26,3,0
6163,48,29,35,13,0,30,65,46.2,35,33,12,21,19,67,78,0
6164,23,19,7,12,4,9,16,56.3,7,11,0,11,3,26,6,0
6165,25,14,7,12,6,9,20,45.0,11,10,0,10,3,28,3,0
6166,4,2,1,2,1,0,2,0.0,2,3,0,3,1,5,6,0
6167,0,0,0,0,0,0,0,0.0,0,0,0,0,0,0,0,0
6168,48,33,34,12,2,27,37,73.0,10,36,18,18,42,90,178,0
6169,14,8,4,9,1,5,18,27.8,13,4,0,4,3,17,1,0
6170,2,0,2,0,0,1,2,50.0,1,4,0,4,1,3,2,0
6171,0,0,0,0,0,0,0,0.0,0,0,0,0,0,0,0,0
6172,2,1,2,0,0,2,2,100.0,0,3,0,3,1,3,0,0
6173,17,10,9,5,3,5,12,41.7,7,13,1,12,3,20,5,1
6174,7,5,1,5,1,4,10,40.0,6,4,0,4,1,8,0,0
6175,26,16,16,6,4,14,23,60.9,9,18,9,9,26,52,37,1
6176,31,16,18,11,2,20,25,80.0,5,13,6,7,16,47,29,1
6177,10,7,3,5,2,4,9,44.4,5,8,2,6,6,16,11,0
6178,38,20,26,11,1,21,37,56.8,16,57,39,18,45,83,184,0
6179,16,10,5,10,1,7,14,50.0,7,9,0,9,8,24,16,0
6180,0,0,0,0,0,0,0,0.0,0,0,0,0,0,0,0,0
6181,23,15,5,12,6,9,16,56.3,7,12,1,11,9,32,3,0
6182,3,2,0,2,1,2,7,28.6,5,2,0,2,3,6,2,0
6183,4,3,2,2,0,1,1,100.0,0,0,0,0,3,7,1,0
6184,23,9,12,10,1,9,21,42.9,12,17,4,13,11,34,20,0
6185,23,12,6,11,6,8,21,38.1,13,21,5,16,3,26,30,0
6186,0,0,0,0,0,0,2,0.0,2,0,0,0,0,0,4,2
6187,91,60,43,34,14,34,64,53.1,30,26,1,25,38,129,56,0
6188,37,27,10,16,11,15,25,60.0,10,13,2,11,18,55,1,0
6189,2,2,2,0,0,1,4,25.0,3,1,0,1,1,3,0,0
6190,4,3,4,0,0,1,2,50.0,1,2,0,2,2,6,9,0
6191,16,9,7,7,2,10,15,66.7,5,5,0,5,8,24,8,0
6192,1,1,0,0,1,0,1,0.0,1,0,0,0,0,1,0,0
6193,3,0,1,0,2,3,4,75.0,1,1,0,1,0,3,2,0
6194,0,0,0,0,0,0,1,0.0,1,1,0,1,0,0,0,0
6195,19,13,8,10,1,12,23,52.2,11,14,1,13,14,33,8,0
6196,3,0,0,2,1,0,2,0.0,2,5,1,4,0,3,7,0
6197,12,10,4,8,0,8,10,80.0,2,9,6,3,7,19,22,0
6198,104,58,38,59,7,54,102,52.9,48,45,4,41,42,146,51,1
6199,16,11,2,9,5,6,14,42.9,8,9,0,9,1,17,4,0
6200,0,0,0,0,0,0,2,0.0,2,0,0,0,0,0,9,1
6201,14,6,7,5,2,6,12,50.0,6,8,4,4,10,24,12,0
6202,26,15,5,17,4,12,19,63.2,7,3,0,3,9,35,4,0
6203,0,0,0,0,0,0,0,0.0,0,3,0,3,1,1,0,0
6204,20,12,5,13,2,11,21,52.4,10,16,5,11,10,30,6,0
6205,35,24,20,10,5,24,40,60.0,16,18,4,14,31,66,43,0
6206,35,24,26,6,3,21,31,67.7,10,17,4,13,15,50,53,1
6207,1,1,1,0,0,1,1,100.0,0,1,0,1,1,2,4,0
6208,18,8,10,7,1,8,15,53.3,7,13,4,9,11,29,29,0
6209,59,40,38,16,5,29,57,50.9,28,15,1,14,18,77,14,0
6210,1,0,0,1,0,0,0,0.0,0,0,0,0,1,2,4,0
6211,7,5,5,2,0,6,7,85.7,1,3,0,3,3,10,5,0
6212,1,1,0,1,0,1,1,100.0,0,4,0,4,0,1,0,0
6213,0,0,0,0,0,0,0,0.0,0,0,0,0,0,0,2,0
6214,43,29,17,20,6,21,39,53.8,18,24,7,17,22,65,26,0
6215,23,14,16,7,0,17,29,58.6,12,12,4,8,12,35,34,0
6216,0,0,0,0,0,0,0,0.0,0,0,0,0,0,0,0,0
6217,4,4,0,3,1,1,10,10.0,9,6,0,6,5,9,4,0
6218,58,35,36,22,0,31,47,66.0,16,48,28,20,54,112,163,0
6219,2,1,0,0,2,1,2,50.0,1,1,1,0,0,2,0,0
6220,6,6,1,3,2,2,6,33.3,4,4,0,4,3,9,5,0
6221,37,24,19,12,6,19,36,52.8,17,26,0,26,16,53,15,0
6222,18,12,9,7,2,6,29,20.7,23,17,3,14,12,30,7,0
6223,36,20,21,12,3,17,28,60.7,11,16,5,11,11,47,21,0
6224,35,19,16,11,8,15,30,50.0,15,14,2,12,14,49,29,0
6225,8,4,3,2,3,1,8,12.5,7,7,2,5,3,11,2,0
6226,3,1,2,0,1,1,2,50.0,1,6,0,6,0,3,5,0
6227,3,2,1,1,1,1,2,50.0,1,1,0,1,0,3,0,0
6228,3,2,0,2,1,2,5,40.0,3,3,0,3,1,4,6,0
6229,1,0,1,0,0,1,1,100.0,0,3,3,0,4,5,1,1
6230,14,7,3,8,3,8,24,33.3,16,15,1,14,11,25,3,1
6231,1,1,0,1,0,1,1,100.0,0,1,0,1,1,2,2,0
6232,71,49,51,13,7,43,77,55.8,34,51,2,49,44,115,80,0
6233,26,15,4,13,9,7,25,28.0,18,23,1,22,13,39,9,0
6234,8,6,1,4,3,3,9,33.3,6,8,1,7,5,13,6,0
6235,0,0,0,0,0,0,0,0.0,0,0,0,0,0,0,0,0
6236,47,30,36,11,0,32,47,68.1,15,51,33,18,50,97,158,2
6237,12,7,5,2,5,6,11,54.5,5,18,1,17,5,17,5,0
6238,0,0,0,0,0,0,2,0.0,2,0,0,0,0,0,25,1
6239,33,24,23,9,1,17,26,65.4,9,16,8,8,21,54,43,1
6240,1,0,0,1,0,0,0,0.0,0,3,0,3,2,3,0,0
6241,28,13,12,12,4,18,40,45.0,22,14,0,14,8,36,14,1
6242,20,13,15,5,0,8,11,72.7,3,20,5,15,18,38,47,0
6243,6,3,5,1,0,4,7,57.1,3,4,2,2,6,12,16,1
6244,8,6,2,4,2,3,13,23.1,10,13,1,12,2,10,10,0
6245,5,1,4,1,0,3,6,50.0,3,10,0,10,4,9,9,0
6246,2,2,1,0,1,1,1,100.0,0,1,0,1,2,4,1,0
6247,40,26,29,11,0,15,22,68.2,7,24,12,12,24,64,73,1
6248,21,12,15,4,2,15,19,78.9,4,14,6,8,5,26,31,0
6249,1,0,1,0,0,1,2,50.0,1,0,0,0,1,2,4,0
6250,0,0,0,0,0,0,0,0.0,0,0,0,0,0,0,11,1
6251,15,9,5,8,2,7,8,87.5,1,10,2,8,4,19,2,0
6252,28,16,12,11,5,9,21,42.9,12,16,8,8,20,48,23,0
6253,6,3,1,5,0,3,9,33.3,6,2,0,2,1,7,0,0
6254,8,5,6,2,0,4,7,57.1,3,2,0,2,9,17,8,0
6255,5,1,3,2,0,2,5,40.0,3,2,0,2,4,9,1,0
6256,41,27,22,16,3,19,33,57.6,14,21,9,12,24,65,49,0
6257,3,1,2,1,0,1,4,25.0,3,3,1,2,1,4,1,0
6258,28,17,18,7,3,12,21,57.1,9,28,20,8,41,69,71,1
6259,0,0,0,0,0,0,0,0.0,0,0,0,0,0,0,0,0
6260,12,7,7,4,1,5,14,35.7,9,4,1,3,7,19,10,0
6261,5,4,1,2,2,3,3,100.0,0,6,1,5,1,6,14,0
6262,0,0,0,0,0,0,0,0.0,0,0,0,0,0,0,15,4
6263,20,10,9,9,2,10,21,47.6,11,13,2,11,14,34,21,0
6264,34,21,19,12,3,19,32,59.4,13,40,15,25,31,65,104,0
6265,7,3,3,2,2,2,5,40.0,3,9,1,8,1,8,26,0
6266,6,4,0,3,3,1,5,20.0,4,16,1,15,1,7,10,0
6267,63,39,46,16,1,36,68,52.9,32,35,24,11,42,105,133,1
6268,30,23,20,10,0,13,19,68.4,6,29,21,8,29,59,118,0
6269,15,9,9,5,1,8,11,72.7,3,3,0,3,7,22,18,1
6270,54,32,34,19,1,22,42,52.4,20,46,29,17,40,94,98,2
6271,6,3,3,3,0,5,9,55.6,4,9,1,8,9,15,14,0
6272,0,0,0,0,0,0,0,0.0,0,0,0,0,0,0,1,0
6273,0,0,0,0,0,0,0,0.0,0,0,0,0,0,0,3,0
6274,20,9,9,6,5,9,17,52.9,8,14,1,13,3,23,7,0
6275,4,2,0,3,1,3,5,60.0,2,0,0,0,1,5,10,0
6276,21,13,12,8,1,15,32,46.9,17,13,4,9,24,45,18,1
6277,2,2,1,1,0,0,3,0.0,3,2,0,2,1,3,6,0
6278,6,4,0,3,3,3,12,25.0,9,10,2,8,4,10,6,0
6279,0,0,0,0,0,0,1,0.0,1,0,0,0,0,0,10,2
6280,0,0,0,0,0,0,0,0.0,0,0,0,0,0,0,0,0
6281,0,0,0,0,0,0,1,0.0,1,0,0,0,0,0,2,1
6282,13,5,8,5,0,6,12,50.0,6,29,25,4,17,30,122,0
6283,12,7,3,5,4,4,8,50.0,4,15,2,13,3,15,12,0
6284,1,1,1,0,0,0,0,0.0,0,0,0,0,0,1,2,0
6285,9,7,3,4,2,6,10,60.0,4,10,1,9,3,12,6,0
6286,2,2,2,0,0,1,1,100.0,0,3,0,3,0,2,3,0
6287,13,10,4,4,5,7,17,41.2,10,16,0,16,3,16,2,0
6288,28,16,16,8,4,18,39,46.2,21,20,6,14,15,43,25,0
6289,55,35,31,20,4,30,56,53.6,26,32,16,16,40,95,76,1
6290,27,19,16,8,3,14,27,51.9,13,27,13,14,25,52,54,0
6291,28,18,20,8,0,17,35,48.6,18,32,23,9,24,52,67,1
6292,31,18,17,11,3,20,34,58.8,14,20,9,11,13,44,30,0
6293,21,15,12,8,1,16,27,59.3,11,13,3,10,15,36,31,0
6294,62,40,38,16,8,34,59,57.6,25,40,16,24,38,100,114,0
6295,7,5,2,1,4,2,7,28.6,5,12,0,12,2,9,12,0
6296,45,31,20,17,8,21,62,33.9,41,31,1,30,12,57,13,2
6297,0,0,0,0,0,0,0,0.0,0,1,1,0,1,1,1,0
6298,16,11,5,9,2,6,15,40.0,9,10,1,9,11,27,23,2
6299,0,0,0,0,0,0,0,0.0,0,0,0,0,0,0,0,0
6300,16,7,2,8,6,2,4,50.0,2,6,0,6,0,16,27,0
6301,28,18,17,7,4,13,17,76.5,4,11,2,9,11,39,20,0
6302,9,5,1,4,4,2,6,33.3,4,7,2,5,0,9,2,0
6303,0,0,0,0,0,0,4,0.0,4,7,3,4,7,7,6,0
6304,12,9,8,4,0,8,14,57.1,6,17,14,3,9,21,31,0
6305,17,9,10,2,5,5,14,35.7,9,17,1,16,9,26,6,0
6306,6,2,0,3,3,2,7,28.6,5,9,4,5,3,9,18,0
6307,12,7,7,3,2,8,15,53.3,7,3,1,2,12,24,15,1
6308,65,40,27,37,1,27,67,40.3,40,39,8,31,50,115,26,0
6309,1,1,1,0,0,1,2,50.0,1,0,0,0,0,1,11,2
6310,9,8,5,0,4,4,6,66.7,2,10,1,9,0,9,7,0
6311,25,18,15,7,3,15,23,65.2,8,21,5,16,12,37,33,1
6312,9,1,2,5,2,6,8,75.0,2,4,1,3,5,14,7,0
6313,0,0,0,0,0,0,2,0.0,2,0,0,0,0,0,6,1
6314,0,0,0,0,0,0,0,0.0,0,0,0,0,1,1,0,0
6315,18,11,6,8,4,6,23,26.1,17,29,3,26,18,36,6,0
6316,34,18,23,8,3,15,22,68.2,7,8,1,7,19,53,27,0
6317,10,5,8,2,0,7,12,58.3,5,3,2,1,12,22,17,0
6318,22,14,13,8,1,10,17,58.8,7,13,9,4,15,37,63,0
6319,14,12,5,8,1,7,17,41.2,10,9,2,7,8,22,7,0
6320,3,2,1,2,0,1,4,25.0,3,3,1,2,2,5,7,0
6321,47,32,30,15,2,24,37,64.9,13,26,11,15,61,108,87,0
6322,1,0,1,0,0,1,3,33.3,2,1,0,1,1,2,20,1
6323,32,18,8,20,4,9,29,31.0,20,25,6,19,18,50,33,0
6324,2,0,0,1,1,2,5,40.0,3,3,1,2,0,2,17,0
6325,13,8,3,9,1,4,9,44.4,5,10,6,4,4,17,39,0
6326,7,7,4,2,1,6,10,60.0,4,5,4,1,4,11,11,0
6327,29,20,18,9,2,16,36,44.4,20,14,3,11,17,46,17,0
6328,7,5,2,1,4,2,3,66.7,1,3,0,3,1,8,1,0
6329,30,18,13,13,4,16,24,66.7,8,16,5,11,10,40,21,0
6330,2,1,2,0,0,1,2,50.0,1,3,0,3,1,3,0,0
6331,0,0,0,0,0,0,0,0.0,0,0,0,0,1,1,0,0
6332,9,6,7,2,0,5,12,41.7,7,14,5,9,13,22,15,0
6333,34,21,26,8,0,20,27,74.1,7,34,29,5,27,61,82,2
6334,28,13,7,10,11,12,20,60.0,8,12,0,12,5,33,5,0
6335,3,1,1,1,1,1,6,16.7,5,2,0,2,1,4,0,0
6336,2,1,0,2,0,1,6,16.7,5,4,0,4,0,2,0,0
6337,1,1,1,0,0,1,2,50.0,1,1,0,1,4,5,28,0
6338,36,20,13,16,7,21,45,46.7,24,22,2,20,4,40,10,0
6339,9,7,3,6,0,4,8,50.0,4,5,0,5,3,12,1,0
6340,3,2,2,1,0,2,3,66.7,1,5,2,3,2,5,2,0
6341,27,15,20,7,0,16,32,50.0,16,45,32,13,46,73,145,0
6342,1,0,0,1,0,1,1,100.0,0,0,0,0,1,2,0,0
6343,26,18,17,6,3,15,30,50.0,15,10,1,9,14,40,25,1
6344,0,0,0,0,0,0,1,0.0,1,1,1,0,5,5,4,0
6345,14,7,7,5,2,5,12,41.7,7,4,0,4,6,20,9,0
6346,2,1,2,0,0,2,3,66.7,1,2,0,2,2,4,23,4
6347,18,10,7,7,4,7,15,46.7,8,11,3,8,14,32,14,0
6348,13,7,9,4,0,7,14,50.0,7,8,2,6,5,18,17,0
6349,37,23,15,16,6,15,41,36.6,26,38,3,35,6,43,6,0
6350,11,6,5,3,3,8,20,40.0,12,9,1,8,5,16,9,0
6351,0,0,0,0,0,0,1,0.0,1,0,0,0,0,0,13,2
6352,55,35,40,12,3,36,59,61.0,23,29,10,19,31,86,77,2
6353,1,1,1,0,0,0,1,0.0,1,1,0,1,0,1,9,0
6354,12,7,9,3,0,7,11,63.6,4,13,7,6,12,24,21,1
6355,27,15,21,6,0,20,27,74.1,7,20,12,8,20,47,51,0
6356,0,0,0,0,0,0,0,0.0,0,0,0,0,0,0,0,0
6357,2,1,0,0,2,2,2,100.0,0,3,1,2,2,4,6,0
6358,40,28,11,17,12,26,45,57.8,19,38,2,36,10,50,5,0
6359,33,19,17,10,6,20,55,36.4,35,35,1,34,17,50,10,0
6360,10,6,7,3,0,5,10,50.0,5,8,2,6,12,22,3,0
6361,62,36,36,22,4,34,61,55.7,27,48,8,40,42,104,71,2
6362,27,15,7,15,5,12,28,42.9,16,17,2,15,2,29,8,0
6363,2,1,0,1,1,2,3,66.7,1,3,1,2,1,3,2,0
6364,3,1,1,1,1,2,5,40.0,3,9,2,7,1,4,5,0
6365,14,8,6,6,2,11,18,61.1,7,16,3,13,6,20,32,0
6366,13,8,11,2,0,7,10,70.0,3,19,14,5,24,37,84,1
6367,56,43,29,15,12,23,40,57.5,17,32,10,22,21,77,47,2
6368,41,27,23,14,4,26,40,65.0,14,20,6,14,31,72,96,0
6369,9,8,7,2,0,5,13,38.5,8,16,13,3,16,25,73,0
6370,72,36,40,31,1,37,50,74.0,13,41,27,14,52,124,157,0
6371,15,8,11,2,2,10,20,50.0,10,19,12,7,15,30,98,2
6372,0,0,0,0,0,0,1,0.0,1,1,0,1,1,1,0,0
6373,6,5,3,1,2,3,5,60.0,2,1,0,1,0,6,6,0
6374,0,0,0,0,0,0,1,0.0,1,2,1,1,1,1,1,0
6375,22,15,11,7,4,13,27,48.1,14,4,1,3,8,30,3,0
6376,81,48,32,41,8,37,72,51.4,35,40,4,36,28,109,23,0
6377,16,12,7,8,1,9,15,60.0,6,17,13,4,33,49,78,1
6378,19,12,6,7,6,4,18,22.2,14,18,1,17,6,25,14,0
6379,14,7,7,5,2,4,5,80.0,1,4,0,4,1,15,0,0
6380,5,2,2,2,1,2,5,40.0,3,3,1,2,1,6,4,0
6381,9,5,3,2,4,3,6,50.0,3,7,0,7,6,15,4,0
6382,4,3,1,3,0,3,10,30.0,7,4,0,4,3,7,1,0
6383,0,0,0,0,0,0,0,0.0,0,0,0,0,0,0,0,0
6384,1,0,1,0,0,1,2,50.0,1,0,0,0,1,2,6,1
6385,20,11,8,7,5,5,9,55.6,4,11,3,8,6,26,12,0
6386,31,16,10,15,6,11,18,61.1,7,19,5,14,20,51,15,0
6387,39,28,24,14,1,21,42,50.0,21,28,5,23,20,59,26,0
6388,11,5,2,5,4,5,12,41.7,7,20,2,18,2,13,23,0
6389,0,0,0,0,0,0,0,0.0,0,0,0,0,0,0,0,0
6390,1,1,1,0,0,0,2,0.0,2,2,0,2,0,1,1,0
6391,92,59,50,30,12,59,88,67.0,29,37,5,32,30,122,40,0
6392,1,0,1,0,0,0,0,0.0,0,0,0,0,0,1,2,0
6393,3,0,3,0,0,0,1,0.0,1,0,0,0,1,4,2,0
6394,2,1,1,1,0,2,4,50.0,2,0,0,0,2,4,1,0
6395,14,8,12,2,0,9,20,45.0,11,10,5,5,30,44,42,0
6396,7,7,3,4,0,4,9,44.4,5,9,1,8,13,20,15,0
6397,3,2,0,1,2,2,4,50.0,2,2,0,2,1,4,0,0
6398,14,8,10,4,0,10,20,50.0,10,14,7,7,24,38,97,1
6399,0,0,0,0,0,0,0,0.0,0,0,0,0,1,1,0,0
6400,17,7,14,3,0,7,14,50.0,7,8,2,6,14,31,24,0
6401,11,5,4,1,6,4,6,66.7,2,5,0,5,1,12,10,0
6402,2,1,1,1,0,1,1,100.0,0,1,0,1,0,2,1,0
6403,16,7,5,6,5,8,20,40.0,12,26,1,25,4,20,6,0
6404,3,2,0,1,2,2,9,22.2,7,3,0,3,2,5,2,0
6405,8,5,3,2,3,6,8,75.0,2,7,0,7,4,12,1,0
6406,8,7,4,4,0,3,5,60.0,2,3,0,3,6,14,1,0
6407,27,16,15,10,2,15,24,62.5,9,9,5,4,12,39,22,0
6408,1,1,0,0,1,1,1,100.0,0,0,0,0,0,1,1,0
6409,4,1,0,2,2,2,5,40.0,3,3,0,3,0,4,6,0
6410,1,0,0,1,0,1,1,100.0,0,0,0,0,0,1,5,1
6411,34,24,20,9,5,16,37,43.2,21,20,7,13,22,56,43,0
6412,1,1,1,0,0,0,3,0.0,3,4,0,4,2,3,5,0
6413,16,7,5,8,3,6,19,31.6,13,8,3,5,5,21,14,0
6414,6,5,1,2,3,1,2,50.0,1,2,1,1,0,6,0,0
6415,70,44,35,27,8,27,53,50.9,26,33,11,22,44,114,42,0
6416,47,32,15,28,4,14,41,34.1,27,32,5,27,18,65,29,0
6417,41,32,22,17,2,21,32,65.6,11,14,5,9,11,52,28,1
6418,15,11,11,4,0,7,16,43.8,9,6,3,3,19,34,38,0
6419,11,8,6,5,0,3,9,33.3,6,7,4,3,8,19,25,0
6420,9,6,3,4,2,4,10,40.0,6,11,0,11,5,14,2,0
6421,15,10,6,6,3,8,18,44.4,10,18,6,12,4,19,29,1
6422,7,6,0,2,5,2,5,40.0,3,4,0,4,3,10,7,0
6423,20,9,12,8,0,10,13,76.9,3,23,17,6,16,36,73,2
6424,15,9,5,8,2,8,23,34.8,15,16,6,10,10,25,18,1
6425,17,10,11,6,0,8,20,40.0,12,15,3,12,18,35,9,0
6426,2,2,2,0,0,1,2,50.0,1,0,0,0,1,3,14,2
6427,7,5,3,3,1,3,4,75.0,1,12,3,9,3,10,6,0
6428,42,24,17,18,7,25,46,54.3,21,29,9,20,27,69,18,0
6429,2,1,0,2,0,2,3,66.7,1,1,0,1,0,2,0,0
6430,33,16,14,17,2,19,52,36.5,33,19,2,17,10,43,10,0
6431,0,0,0,0,0,0,1,0.0,1,0,0,0,0,0,0,0
6432,3,2,0,3,0,2,7,28.6,5,6,0,6,2,5,14,0
6433,0,0,0,0,0,0,1,0.0,1,0,0,0,0,0,1,0
6434,23,16,8,10,5,5,21,23.8,16,23,0,23,11,34,7,1
6435,0,0,0,0,0,0,0,0.0,0,0,0,0,0,0,0,0
6436,26,20,13,8,5,17,20,85.0,3,15,5,10,24,50,43,0
6437,15,8,6,9,0,8,13,61.5,5,19,1,18,8,23,9,0
6438,0,0,0,0,0,0,0,0.0,0,0,0,0,0,0,0,0
6439,40,29,21,17,2,24,41,58.5,17,16,3,13,22,62,32,0
6440,24,20,13,10,1,10,21,47.6,11,9,0,9,13,37,17,0
6441,43,26,18,17,8,23,47,48.9,24,13,2,11,16,59,10,0
6442,2,1,2,0,0,2,3,66.7,1,0,0,0,0,2,17,2
6443,3,1,3,0,0,1,1,100.0,0,2,1,1,0,3,2,0
6444,1,1,0,1,0,0,2,0.0,2,5,0,5,0,1,3,0
6445,18,12,14,4,0,13,22,59.1,9,3,0,3,2,20,14,1
6446,5,2,2,1,2,1,5,20.0,4,7,4,3,3,8,9,0
6447,0,0,0,0,0,0,1,0.0,1,1,0,1,0,0,2,0
6448,27,15,9,13,5,14,36,38.9,22,17,2,15,5,32,3,0
6449,16,8,5,9,2,9,21,42.9,12,8,1,7,11,27,5,0
6450,6,4,3,3,0,3,6,50.0,3,6,0,6,1,7,2,0
6451,1,0,0,1,0,1,2,50.0,1,2,0,2,1,2,0,0
6452,3,2,2,0,1,2,4,50.0,2,3,0,3,4,7,3,0
6453,44,27,19,17,8,14,25,56.0,11,42,3,39,16,60,2,0
6454,10,7,2,6,2,4,7,57.1,3,14,0,14,1,11,8,0
6455,6,3,4,2,0,2,4,50.0,2,6,3,3,3,9,14,0
6456,66,46,22,23,21,28,60,46.7,32,35,3,32,25,91,41,0
6457,11,8,6,3,2,5,11,45.5,6,6,1,5,6,17,29,0
6458,65,44,43,15,7,26,53,49.1,27,35,6,29,22,87,49,1
6459,77,50,27,44,6,38,67,56.7,29,22,3,19,40,117,39,2
6460,31,21,20,9,2,18,28,64.3,10,34,21,13,24,55,98,1
6461,16,11,1,10,5,3,11,27.3,8,19,3,16,5,21,20,1
6462,4,1,2,1,1,1,2,50.0,1,2,0,2,1,5,0,0
6463,38,23,13,16,9,14,39,35.9,25,23,2,21,10,48,14,0
6464,25,17,9,14,2,12,26,46.2,14,16,3,13,14,39,28,1
6465,3,3,1,2,0,1,4,25.0,3,20,13,7,15,18,69,1
6466,44,33,32,12,0,15,20,75.0,5,32,26,6,44,88,191,2
6467,59,41,25,26,8,30,56,53.6,26,50,12,38,42,101,47,0
6468,0,0,0,0,0,0,3,0.0,3,0,0,0,0,0,5,0
6469,0,0,0,0,0,0,0,0.0,0,0,0,0,0,0,5,1
6470,0,0,0,0,0,0,0,0.0,0,0,0,0,0,0,1,1
6471,24,14,7,11,6,11,26,42.3,15,25,0,25,13,37,9,0
6472,22,17,14,6,2,17,31,54.8,14,28,13,15,21,43,74,0
6473,34,23,21,10,3,20,33,60.6,13,20,5,15,25,59,53,0
6474,6,5,4,1,1,5,6,83.3,1,0,0,0,2,8,4,0
6475,6,3,3,2,1,5,9,55.6,4,2,1,1,3,9,6,0
6476,6,5,3,3,0,1,3,33.3,2,10,7,3,4,10,21,2
6477,15,8,4,7,4,9,18,50.0,9,10,0,10,5,20,6,0
6478,50,31,36,13,1,28,46,60.9,18,33,26,7,39,89,153,3
6479,44,28,17,19,8,27,77,35.1,50,23,2,21,14,58,14,1
6480,19,13,13,6,0,7,12,58.3,5,55,40,15,46,65,131,2
6481,8,4,1,5,2,1,8,12.5,7,18,4,14,1,9,6,0
6482,0,0,0,0,0,0,1,0.0,1,0,0,0,0,0,11,0
6483,0,0,0,0,0,0,0,0.0,0,0,0,0,0,0,0,0
6484,40,24,22,15,3,22,45,48.9,23,19,8,11,14,54,51,0
6485,9,6,7,1,1,4,12,33.3,8,10,2,8,12,21,9,0
6486,36,20,9,22,5,21,50,42.0,29,23,4,19,39,75,31,0
6487,106,60,45,56,5,47,84,56.0,37,45,10,35,42,148,23,2
6488,2,2,1,1,0,0,4,0.0,4,2,0,2,5,7,11,0
6489,5,5,4,1,0,2,5,40.0,3,4,0,4,4,9,10,0
6490,3,2,0,2,1,0,5,0.0,5,3,0,3,4,7,8,0
6491,38,19,20,14,4,26,46,56.5,20,24,13,11,42,80,50,0
6492,2,1,2,0,0,0,0,0.0,0,2,0,2,0,2,2,0
6493,22,16,9,13,0,10,22,45.5,12,14,2,12,19,41,19,0
6494,18,11,15,1,2,7,19,36.8,12,26,15,11,31,49,74,0
6495,0,0,0,0,0,0,1,0.0,1,0,0,0,0,0,4,1
6496,14,10,5,6,3,5,11,45.5,6,7,0,7,7,21,3,0
6497,5,3,0,3,2,1,7,14.3,6,6,0,6,4,9,9,0
6498,5,5,2,3,0,3,7,42.9,4,6,0,6,0,5,5,0
6499,10,5,3,5,2,3,12,25.0,9,8,1,7,2,12,17,0
6500,36,24,22,9,5,22,33,66.7,11,30,4,26,20,56,52,1
6501,47,33,13,28,6,20,50,40.0,30,14,1,13,17,64,3,1
6502,32,21,13,12,7,20,29,69.0,9,14,3,11,13,45,12,0
6503,26,17,15,7,4,12,27,44.4,15,26,4,22,15,41,18,0
6504,9,5,5,0,4,3,11,27.3,8,9,0,9,8,17,9,0
6505,3,2,3,0,0,3,5,60.0,2,0,0,0,1,4,28,2
6506,0,0,0,0,0,0,0,0.0,0,0,0,0,0,0,0,0
6507,5,5,3,2,0,3,5,60.0,2,1,1,0,5,10,7,0
6508,38,34,17,16,5,21,52,40.4,31,29,4,25,9,47,39,0
6509,0,0,0,0,0,0,1,0.0,1,1,0,1,0,0,0,0
6510,14,12,6,6,2,7,16,43.8,9,8,0,8,3,17,4,0
6511,0,0,0,0,0,0,0,0.0,0,0,0,0,0,0,2,0
6512,0,0,0,0,0,0,0,0.0,0,1,0,1,0,0,15,0
6513,11,5,4,4,3,4,9,44.4,5,3,0,3,3,14,5,0
6514,2,1,0,0,2,2,3,66.7,1,0,0,0,0,2,0,0
6515,3,3,0,3,0,0,0,0.0,0,1,0,1,0,3,1,0
6516,29,18,9,16,4,10,19,52.6,9,15,1,14,8,37,7,0
6517,10,8,5,4,1,6,13,46.2,7,10,4,6,1,11,8,0
6518,9,2,5,4,0,5,10,50.0,5,16,9,7,21,30,59,1
6519,7,3,4,3,0,4,6,66.7,2,4,1,3,16,23,22,2
6520,39,21,16,19,4,19,31,61.3,12,27,7,20,32,71,26,0
6521,4,2,3,0,1,2,4,50.0,2,5,0,5,0,4,4,0
6522,2,1,0,2,0,0,1,0.0,1,4,3,1,0,2,7,0
6523,2,1,2,0,0,2,10,20.0,8,0,0,0,0,2,21,4
6524,9,4,6,3,0,6,11,54.5,5,4,3,1,8,17,33,0
6525,19,12,6,12,1,6,19,31.6,13,15,4,11,6,25,18,1
6526,47,30,17,27,3,17,31,54.8,14,26,11,15,14,61,43,0
6527,14,6,6,6,2,7,15,46.7,8,20,2,18,7,21,15,1
6528,13,8,8,5,0,8,14,57.1,6,10,1,9,4,17,8,0
6529,0,0,0,0,0,0,0,0.0,0,0,0,0,0,0,0,1
6530,63,41,44,17,2,40,63,63.5,23,80,54,26,54,117,190,3
6531,9,5,1,6,2,5,12,41.7,7,7,3,4,3,12,13,0
6532,22,15,14,6,2,12,22,54.5,10,15,4,11,15,37,25,0
6533,3,2,0,2,1,1,1,100.0,0,3,0,3,1,4,6,0
6534,48,35,18,21,9,17,40,42.5,23,54,5,49,26,74,26,0
6535,45,30,28,14,3,27,50,54.0,23,32,12,20,36,81,114,0
6536,13,10,5,4,4,5,11,45.5,6,16,1,15,3,16,22,0
6537,7,3,3,4,0,2,3,66.7,1,3,1,2,2,9,5,0
6538,46,29,29,12,5,27,47,57.4,20,15,7,8,22,68,55,0
6539,0,0,0,0,0,0,0,0.0,0,1,1,0,0,0,1,0
6540,63,34,29,28,6,27,67,40.3,40,24,1,23,22,85,10,0
6541,13,8,4,5,4,3,14,21.4,11,5,0,5,2,15,8,0
6542,8,5,6,1,1,3,10,30.0,7,3,0,3,0,8,3,0
6543,26,13,17,8,1,11,17,64.7,6,13,7,6,28,54,59,0
6544,0,0,0,0,0,0,1,0.0,1,0,0,0,0,0,5,2
6545,80,54,44,27,9,45,87,51.7,42,61,10,51,45,125,48,0
6546,8,5,3,4,1,2,8,25.0,6,5,1,4,2,10,14,0
6547,2,1,2,0,0,0,0,0.0,0,0,0,0,0,2,12,3
6548,0,0,0,0,0,0,1,0.0,1,0,0,0,0,0,15,4
6549,8,7,2,5,1,3,10,30.0,7,7,1,6,3,11,2,0
6550,50,29,37,13,0,29,45,64.4,16,47,21,26,58,108,111,3
6551,60,36,29,26,5,40,67,59.7,27,46,21,25,39,99,113,2
6552,20,11,7,7,6,8,20,40.0,12,13,3,10,4,24,4,0
6553,39,25,18,19,2,18,33,54.5,15,30,4,26,17,56,37,0
6554,6,2,2,3,1,4,8,50.0,4,5,1,4,8,14,3,0
6555,55,32,18,30,7,26,60,43.3,34,27,6,21,41,96,21,0
6556,1,1,0,1,0,1,2,50.0,1,0,0,0,1,2,0,0
6557,18,13,8,9,1,9,32,28.1,23,5,0,5,6,24,11,0
6558,59,38,34,22,3,37,62,59.7,25,29,2,27,20,79,48,0
6559,22,12,17,3,2,11,14,78.6,3,22,12,10,15,37,55,0
6560,27,18,13,11,3,14,21,66.7,7,20,9,11,20,47,59,0
6561,0,0,0,0,0,0,1,0.0,1,1,0,1,1,1,3,0
6562,0,0,0,0,0,0,0,0.0,0,1,0,1,0,0,0,0
6563,52,30,23,23,6,23,57,40.4,34,25,3,22,10,62,17,0
6564,7,5,5,1,1,5,9,55.6,4,7,3,4,4,11,10,0
6565,16,5,5,6,5,4,15,26.7,11,17,2,15,16,32,6,0
6566,12,10,5,4,3,8,30,26.7,22,31,3,28,4,16,14,0
6567,5,2,0,2,3,4,12,33.3,8,10,2,8,7,12,13,1
6568,28,21,18,9,1,14,25,56.0,11,7,3,4,14,42,16,2
6569,48,30,18,22,8,27,65,41.5,38,32,9,23,23,71,36,0
6570,42,28,13,17,12,18,41,43.9,23,27,2,25,11,53,7,1
6571,65,39,35,26,4,35,65,53.8,30,16,2,14,35,100,55,0
6572,0,0,0,0,0,0,0,0.0,0,0,0,0,0,0,0,0
6573,41,28,28,10,3,22,41,53.7,19,36,13,23,25,66,79,1
6574,1,1,0,1,0,0,0,0.0,0,0,0,0,0,1,1,0
6575,10,6,2,6,2,4,8,50.0,4,10,0,10,5,15,3,0
6576,38,22,27,10,1,18,25,72.0,7,26,19,7,30,68,81,0
6577,12,9,9,3,0,5,10,50.0,5,14,11,3,11,23,46,1
6578,6,5,3,2,1,4,9,44.4,5,6,0,6,2,8,2,0
6579,0,0,0,0,0,0,1,0.0,1,0,0,0,0,0,10,3
6580,3,2,3,0,0,2,6,33.3,4,4,1,3,0,3,11,0
6581,6,5,4,1,1,4,9,44.4,5,3,1,2,1,7,4,0
6582,14,10,7,6,1,8,17,47.1,9,6,3,3,11,25,4,0
6583,22,16,12,8,2,17,25,68.0,8,10,2,8,13,35,22,0
6584,8,4,5,3,0,6,7,85.7,1,10,5,5,10,18,24,0
6585,4,2,0,3,1,2,4,50.0,2,4,0,4,2,6,5,0
6586,43,28,24,14,5,28,53,52.8,25,42,7,35,33,76,53,0
6587,45,22,18,22,5,14,49,28.6,35,29,3,26,8,53,11,1
6588,11,8,5,4,2,6,10,60.0,4,7,0,7,3,14,1,0
6589,42,27,23,13,6,18,25,72.0,7,20,11,9,16,58,67,0
6590,10,8,3,7,0,6,16,37.5,10,11,1,10,4,14,2,0
6591,10,3,2,5,3,4,7,57.1,3,4,1,3,0,10,8,0
6592,4,0,0,1,3,1,4,25.0,3,1,0,1,1,5,9,0
6593,21,11,1,13,7,5,16,31.3,11,22,4,18,4,25,24,0
6594,0,0,0,0,0,0,0,0.0,0,0,0,0,1,1,16,1
6595,62,39,38,22,2,34,45,75.6,11,39,16,23,41,103,95,1
6596,12,9,7,5,0,7,16,43.8,9,9,5,4,8,20,49,0
6597,45,34,23,15,7,26,37,70.3,11,34,7,27,22,67,48,1
6598,62,35,33,23,6,42,58,72.4,16,29,5,24,24,86,45,0
6599,4,3,4,0,0,2,6,33.3,4,3,1,2,1,5,5,1
6600,4,4,2,2,0,2,2,100.0,0,3,0,3,4,8,1,0
6601,37,22,19,15,3,21,37,56.8,16,33,12,21,27,64,80,0
6602,1,0,0,1,0,0,0,0.0,0,1,0,1,0,1,0,0
6603,32,19,13,13,6,15,41,36.6,26,16,0,16,19,51,16,0
6604,0,0,0,0,0,0,1,0.0,1,0,0,0,0,0,4,1
6605,23,14,16,6,1,13,15,86.7,2,13,7,6,7,30,26,0
6606,22,15,15,3,4,12,22,54.5,10,32,15,17,34,56,97,1
6607,12,6,5,7,0,7,19,36.8,12,7,2,5,3,15,2,0
6608,22,15,14,7,1,6,16,37.5,10,17,5,12,7,29,14,1
6609,18,12,5,11,2,12,23,52.2,11,4,2,2,8,26,4,0
6610,44,28,29,8,7,34,51,66.7,17,12,6,6,10,54,47,0
6611,1,1,0,1,0,1,1,100.0,0,0,0,0,0,1,1,0
6612,42,20,23,14,5,20,49,40.8,29,39,4,35,27,69,35,0
6613,19,13,11,3,5,8,19,42.1,11,15,0,15,17,36,18,1
6614,11,5,2,5,4,3,5,60.0,2,4,0,4,1,12,18,0
6615,40,27,27,8,5,20,38,52.6,18,17,7,10,24,64,49,0
6616,8,5,1,5,2,3,5,60.0,2,5,0,5,3,11,3,0
6617,9,3,4,5,0,5,6,83.3,1,3,0,3,7,16,0,0
6618,24,13,6,14,4,14,24,58.3,10,13,0,13,15,39,2,0
6619,5,4,3,2,0,3,3,100.0,0,4,0,4,3,8,2,1
6620,17,12,5,8,4,4,18,22.2,14,16,2,14,6,23,6,0
6621,25,15,14,9,2,9,17,52.9,8,10,2,8,5,30,27,0
6622,5,1,0,2,3,1,1,100.0,0,3,0,3,3,8,4,0
6623,8,4,1,5,2,1,5,20.0,4,2,1,1,7,15,16,0
6624,0,0,0,0,0,0,0,0.0,0,0,0,0,0,0,1,0
6625,0,0,0,0,0,0,0,0.0,0,1,0,1,0,0,0,0
6626,0,0,0,0,0,0,0,0.0,0,0,0,0,1,1,0,0
6627,15,9,5,6,4,9,20,45.0,11,20,2,18,6,21,6,0
6628,6,4,2,1,3,1,8,12.5,7,4,0,4,3,9,1,0
6629,0,0,0,0,0,0,0,0.0,0,1,0,1,0,0,0,0
6630,15,10,3,9,3,7,12,58.3,5,11,1,10,15,30,8,0
6631,1,0,1,0,0,1,2,50.0,1,0,0,0,0,1,0,0
6632,41,26,23,10,8,26,49,53.1,23,26,6,20,29,70,35,0
6633,3,2,0,3,0,2,3,66.7,1,2,0,2,2,5,0,0
6634,78,54,43,19,16,37,65,56.9,28,67,13,54,39,117,104,1
6635,41,29,17,21,3,28,39,71.8,11,21,7,14,15,56,37,1
6636,1,0,0,1,0,0,0,0.0,0,1,0,1,0,1,0,0
6637,14,7,5,6,3,6,13,46.2,7,12,6,6,3,17,12,1
6638,35,17,11,18,6,13,25,52.0,12,21,2,19,8,43,9,0
6639,31,21,15,11,5,19,38,50.0,19,18,6,12,13,44,43,0
6640,4,2,1,2,1,2,7,28.6,5,2,0,2,4,8,4,0
6641,22,14,9,11,2,13,22,59.1,9,10,4,6,8,30,15,0
6642,13,8,5,2,6,7,14,50.0,7,8,0,8,7,20,4,0
6643,0,0,0,0,0,0,0,0.0,0,0,0,0,0,0,0,0
6644,16,9,13,3,0,9,15,60.0,6,11,2,9,8,24,37,0
6645,12,6,2,9,1,6,8,75.0,2,7,1,6,5,17,9,0
6646,3,3,1,2,0,3,7,42.9,4,1,0,1,1,4,3,0
6647,0,0,0,0,0,0,0,0.0,0,0,0,0,0,0,0,0
6648,25,16,17,7,1,18,28,64.3,10,51,35,16,49,74,184,1
6649,1,1,1,0,0,1,2,50.0,1,0,0,0,0,1,5,1
6650,5,3,4,1,0,1,4,25.0,3,0,0,0,5,10,3,0
6651,2,0,1,1,0,1,3,33.3,2,0,0,0,2,4,2,0
6652,40,30,14,17,9,25,63,39.7,38,37,3,34,11,51,27,1
6653,20,11,14,6,0,15,21,71.4,6,26,17,9,32,52,104,1
6654,2,1,1,1,0,2,6,33.3,4,5,0,5,2,4,6,0
6655,85,58,53,25,7,51,92,55.4,41,65,25,40,53,138,99,0
6656,6,3,1,5,0,3,10,30.0,7,8,0,8,8,14,12,0
6657,6,3,1,2,3,1,4,25.0,3,2,0,2,1,7,6,0
6658,2,1,2,0,0,1,3,33.3,2,0,0,0,1,3,12,1
6659,20,11,7,10,3,6,22,27.3,16,19,2,17,3,23,6,1
6660,4,3,4,0,0,2,4,50.0,2,13,12,1,18,22,45,0
6661,0,0,0,0,0,0,3,0.0,3,0,0,0,0,0,7,4
6662,2,1,2,0,0,2,4,50.0,2,0,0,0,3,5,17,4
6663,22,19,8,11,3,12,36,33.3,24,12,1,11,14,36,5,0
6664,82,50,36,37,9,35,61,57.4,26,45,4,41,49,131,37,1
6665,3,2,2,1,0,2,6,33.3,4,4,1,3,2,5,2,0
6666,46,35,39,5,2,31,47,66.0,16,23,11,12,48,94,101,1
6667,0,0,0,0,0,0,1,0.0,1,0,0,0,0,0,10,1
6668,61,37,37,13,11,30,56,53.6,26,32,7,25,42,103,79,1
6669,29,18,6,15,8,15,28,53.6,13,21,2,19,6,35,14,0
6670,2,2,1,0,1,1,2,50.0,1,1,0,1,1,3,2,0
6671,11,8,1,9,1,4,6,66.7,2,6,1,5,3,14,7,0
6672,74,43,34,33,7,40,60,66.7,20,31,8,23,55,129,115,0
6673,0,0,0,0,0,0,0,0.0,0,0,0,0,0,0,21,5
6674,0,0,0,0,0,0,0,0.0,0,1,0,1,1,1,0,0
6675,1,0,0,0,1,1,2,50.0,1,1,1,0,1,2,1,0
6676,0,0,0,0,0,0,1,0.0,1,0,0,0,0,0,1,2
6677,0,0,0,0,0,0,0,0.0,0,1,0,1,0,0,0,0
6678,13,5,1,7,5,4,12,33.3,8,14,4,10,7,20,20,0
6679,40,25,13,21,6,21,49,42.9,28,31,9,22,25,65,31,0
6680,4,2,2,2,0,1,2,50.0,1,2,1,1,2,6,15,0
6681,7,4,4,2,1,5,17,29.4,12,10,0,10,1,8,0,0
6682,27,22,12,9,6,10,32,31.3,22,22,2,20,8,35,3,0
6683,48,30,32,16,0,24,30,80.0,6,27,19,8,21,69,143,1
6684,46,32,22,18,6,23,42,54.8,19,20,3,17,26,72,57,0
6685,23,18,18,5,0,14,22,63.6,8,25,15,10,23,46,103,0
6686,38,19,14,13,11,16,46,34.8,30,44,5,39,19,57,24,0
6687,1,1,1,0,0,1,3,33.3,2,0,0,0,1,2,9,4
6688,7,3,2,4,1,3,5,60.0,2,3,0,3,6,13,8,0
6689,23,14,13,8,2,16,27,59.3,11,7,1,6,21,44,20,0
6690,16,13,11,4,1,9,12,75.0,3,7,1,6,8,24,23,0
6691,20,15,13,7,0,7,9,77.8,2,20,13,7,19,39,41,1
6692,32,16,13,16,3,20,44,45.5,24,24,3,21,14,46,28,1
6693,71,51,28,35,8,34,67,50.7,33,44,0,44,24,95,58,0
6694,14,10,11,3,0,10,23,43.5,13,19,14,5,17,31,79,1
6695,7,2,5,2,0,3,4,75.0,1,2,0,2,2,9,4,0
6696,20,16,9,7,4,12,19,63.2,7,8,2,6,8,28,5,0
6697,28,16,22,6,0,14,18,77.8,4,21,11,10,21,49,69,0
6698,1,1,1,0,0,1,2,50.0,1,0,0,0,0,1,0,0
6699,10,6,1,6,3,6,22,27.3,16,12,0,12,5,15,6,0
6700,17,11,9,4,4,10,24,41.7,14,27,2,25,6,23,10,1
6701,39,23,20,14,5,13,39,33.3,26,25,2,23,14,53,9,0
6702,40,21,30,9,1,27,37,73.0,10,34,16,18,19,59,143,0
6703,52,30,29,23,0,25,41,61.0,16,18,5,13,32,84,33,0
6704,0,0,0,0,0,0,2,0.0,2,0,0,0,1,1,0,0
6705,21,11,9,9,3,6,11,54.5,5,12,4,8,5,26,18,0
6706,0,0,0,0,0,0,0,0.0,0,0,0,0,0,0,0,0
6707,7,5,0,3,4,3,12,25.0,9,10,0,10,2,9,5,0
6708,23,12,8,13,2,10,22,45.5,12,5,2,3,10,33,7,0
6709,3,0,2,1,0,2,5,40.0,3,1,1,0,8,11,1,0
6710,19,11,6,8,5,14,31,45.2,17,7,1,6,3,22,2,0
6711,10,5,3,7,0,7,13,53.8,6,11,0,11,2,12,1,0
6712,17,12,9,7,1,8,18,44.4,10,9,2,7,8,25,12,0
6713,3,3,1,1,1,2,5,40.0,3,2,0,2,1,4,1,0
6714,22,16,12,5,5,11,33,33.3,22,28,6,22,14,36,34,0
6715,20,13,7,9,4,9,20,45.0,11,10,0,10,16,36,20,0
6716,26,16,7,16,3,13,26,50.0,13,25,2,23,17,43,15,0
6717,0,0,0,0,0,0,1,0.0,1,0,0,0,0,0,0,0
6718,11,9,5,5,1,6,9,66.7,3,9,3,6,17,28,19,0
6719,3,3,1,2,0,2,2,100.0,0,3,3,0,3,6,6,0
6720,0,0,0,0,0,0,2,0.0,2,2,0,2,0,0,1,0
6721,0,0,0,0,0,0,0,0.0,0,0,0,0,0,0,0,0
6722,19,7,2,16,1,9,18,50.0,9,16,5,11,17,36,13,2
6723,4,4,0,3,1,1,5,20.0,4,3,0,3,0,4,6,0
6724,46,25,10,32,4,19,58,32.8,39,11,1,10,27,73,12,0
6725,2,1,1,0,1,2,5,40.0,3,2,0,2,1,3,8,0
6726,19,15,3,9,7,8,12,66.7,4,18,7,11,5,24,11,0
6727,54,37,37,17,0,20,28,71.4,8,25,15,10,15,69,95,1
6728,2,2,0,0,2,2,10,20.0,8,4,1,3,4,6,2,0
6729,0,0,0,0,0,0,0,0.0,0,0,0,0,0,0,0,0
6730,22,14,17,4,1,14,14,100.0,0,20,16,4,26,48,93,2
6731,9,7,3,4,2,3,16,18.8,13,23,1,22,11,20,27,0
6732,9,6,2,2,5,2,12,16.7,10,12,2,10,2,11,18,0
6733,3,2,0,1,2,0,0,0.0,0,0,0,0,0,3,2,0
6734,46,34,16,22,8,25,47,53.2,22,26,7,19,21,67,27,1
6735,2,1,0,2,0,0,0,0.0,0,0,0,0,0,2,0,0
6736,8,4,6,2,0,4,8,50.0,4,16,11,5,10,18,43,2
6737,0,0,0,0,0,0,0,0.0,0,0,0,0,0,0,4,0
6738,7,7,2,4,1,5,12,41.7,7,14,1,13,3,10,6,0
6739,18,10,7,10,1,10,18,55.6,8,9,2,7,2,20,5,0
6740,0,0,0,0,0,0,0,0.0,0,1,1,0,0,0,0,0
6741,49,29,20,24,5,28,54,51.9,26,35,1,34,15,64,5,0
6742,75,43,34,35,6,29,61,47.5,32,56,19,37,39,114,46,0
6743,15,6,0,8,7,3,12,25.0,9,15,3,12,4,19,30,0
6744,6,5,5,1,0,5,14,35.7,9,12,2,10,8,14,10,0
6745,4,1,3,1,0,2,4,50.0,2,2,0,2,0,4,0,0
6746,15,9,11,4,0,12,19,63.2,7,19,13,6,11,26,40,0
6747,49,32,25,21,3,23,55,41.8,32,31,2,29,23,72,27,0
6748,11,5,2,8,1,5,17,29.4,12,12,3,9,6,17,15,0
6749,0,0,0,0,0,0,0,0.0,0,0,0,0,0,0,4,0
6750,17,12,11,5,1,9,14,64.3,5,8,0,8,3,20,10,1
6751,14,6,7,7,0,5,8,62.5,3,6,2,4,6,20,15,0
6752,0,0,0,0,0,0,0,0.0,0,0,0,0,0,0,13,1
6753,11,6,4,6,1,6,13,46.2,7,4,1,3,2,13,6,0
6754,1,0,0,1,0,0,5,0.0,5,8,1,7,2,3,15,0
6755,137,91,51,80,6,47,91,51.6,44,33,12,21,42,179,33,0
6756,5,4,2,1,2,1,3,33.3,2,3,1,2,2,7,1,0
6757,3,2,1,1,1,1,4,25.0,3,3,0,3,2,5,3,0
6758,0,0,0,0,0,0,0,0.0,0,0,0,0,0,0,0,0
6759,6,4,2,3,1,2,5,40.0,3,2,0,2,1,7,6,0
6760,1,0,1,0,0,1,1,100.0,0,0,0,0,0,1,1,0
6761,9,7,7,2,0,7,11,63.6,4,5,5,0,8,17,30,0
6762,41,27,18,16,7,24,62,38.7,38,31,1,30,16,57,6,1
6763,1,1,0,1,0,0,0,0.0,0,1,0,1,0,1,0,0
6764,0,0,0,0,0,0,2,0.0,2,0,0,0,1,1,20,3
6765,5,4,0,4,1,4,12,33.3,8,5,1,4,2,7,2,0
6766,10,7,2,4,4,3,7,42.9,4,5,2,3,3,13,9,0
6767,21,9,11,8,2,9,20,45.0,11,14,8,6,23,44,34,0
6768,0,0,0,0,0,0,0,0.0,0,0,0,0,1,1,1,0
6769,2,1,0,1,1,1,3,33.3,2,1,0,1,2,4,1,0
6770,2,1,2,0,0,1,1,100.0,0,0,0,0,0,2,0,0
6771,41,25,15,19,7,15,43,34.9,28,48,11,37,25,66,34,0
6772,25,15,9,13,3,13,26,50.0,13,28,1,27,8,33,16,1
6773,7,4,4,3,0,5,12,41.7,7,4,1,3,2,9,2,0
6774,2,2,2,0,0,1,1,100.0,0,0,0,0,0,2,15,3
6775,7,3,6,1,0,3,8,37.5,5,3,0,3,1,8,3,0
6776,3,0,3,0,0,0,1,0.0,1,3,2,1,7,10,21,1
6777,5,5,1,3,1,0,2,0.0,2,1,0,1,1,6,0,0
6778,15,6,12,3,0,4,8,50.0,4,10,5,5,2,17,19,0
6779,74,45,34,36,4,35,74,47.3,39,20,6,14,22,96,30,0
6780,68,39,45,21,2,36,92,39.1,56,51,7,44,39,107,62,0
6781,24,14,3,14,7,10,34,29.4,24,20,0,20,1,25,4,1
6782,34,23,13,15,6,15,21,71.4,6,15,7,8,17,51,45,0
6783,0,0,0,0,0,0,0,0.0,0,0,0,0,0,0,4,0
6784,27,19,12,12,3,18,26,69.2,8,17,5,12,24,51,35,0
6785,22,12,4,13,5,11,38,28.9,27,33,5,28,18,40,18,1
6786,4,1,1,2,1,1,5,20.0,4,6,3,3,3,7,6,0
6787,0,0,0,0,0,0,0,0.0,0,0,0,0,0,0,0,0
6788,23,15,12,7,4,12,24,50.0,12,12,2,10,12,35,11,0
6789,40,25,24,11,5,21,30,70.0,9,26,9,17,35,75,49,0
6790,8,3,2,3,3,1,7,14.3,6,6,0,6,2,10,2,0
6791,23,13,18,5,0,17,25,68.0,8,20,13,7,28,51,102,2
6792,18,13,11,6,1,11,17,64.7,6,7,3,4,4,22,20,0
6793,80,55,50,23,7,45,68,66.2,23,49,8,41,24,104,92,4
6794,1,0,1,0,0,1,1,100.0,0,1,1,0,1,2,0,1
6795,40,25,25,13,2,24,46,52.2,22,38,16,22,30,70,83,0
6796,37,23,21,10,6,11,34,32.4,23,15,2,13,8,45,15,0
6797,14,9,6,4,4,10,20,50.0,10,4,0,4,8,22,7,0
6798,29,17,23,5,1,15,29,51.7,14,24,16,8,31,60,124,0
6799,0,0,0,0,0,0,2,0.0,2,0,0,0,1,1,2,0
6800,13,7,2,7,4,5,10,50.0,5,10,2,8,2,15,13,1
6801,29,14,8,18,3,17,35,48.6,18,25,4,21,9,38,25,0
6802,0,0,0,0,0,0,0,0.0,0,0,0,0,1,1,1,0
6803,5,3,4,1,0,4,5,80.0,1,2,0,2,1,6,8,0
6804,32,20,18,12,2,20,60,33.3,40,22,5,17,20,52,26,2
6805,37,22,12,20,5,17,51,33.3,34,24,0,24,27,64,35,0
6806,6,3,2,4,0,3,4,75.0,1,7,6,1,7,13,25,1
6807,0,0,0,0,0,0,0,0.0,0,0,0,0,0,0,13,0
6808,56,41,31,19,6,28,48,58.3,20,30,7,23,29,85,98,2
6809,18,12,6,9,3,11,17,64.7,6,4,1,3,3,21,7,0
6810,23,17,7,12,4,14,47,29.8,33,15,0,15,8,31,14,0
6811,1,1,1,0,0,1,1,100.0,0,0,0,0,1,2,1,0
6812,26,18,4,14,8,7,21,33.3,14,11,1,10,4,30,5,0
6813,1,1,0,1,0,0,0,0.0,0,4,0,4,1,2,6,0
6814,41,27,24,13,4,17,34,50.0,17,27,4,23,22,63,23,1
6815,17,9,11,5,1,5,26,19.2,21,20,1,19,8,25,5,1
6816,73,38,26,35,12,32,62,51.6,30,27,5,22,18,91,19,0
6817,7,4,2,3,2,4,6,66.7,2,4,2,2,0,7,14,0
6818,11,8,2,3,6,5,8,62.5,3,7,1,6,2,13,8,0
6819,18,11,9,7,2,10,17,58.8,7,5,0,5,5,23,0,0
6820,25,16,16,7,2,14,23,60.9,9,10,5,5,8,33,12,0
6821,26,18,16,8,2,21,30,70.0,9,8,3,5,7,33,18,0
6822,21,12,11,10,0,10,20,50.0,10,15,10,5,24,45,77,1
6823,41,24,15,20,6,15,40,37.5,25,19,2,17,19,60,12,0
6824,47,33,22,11,14,22,84,26.2,62,37,2,35,21,68,23,0
6825,5,3,4,1,0,5,10,50.0,5,6,1,5,1,6,4,0
6826,60,42,31,17,12,36,58,62.1,22,29,3,26,26,86,48,1
6827,3,2,2,1,0,3,4,75.0,1,0,0,0,3,6,0,0
6828,14,8,4,5,5,7,14,50.0,7,7,0,7,2,16,2,0
6829,45,23,21,18,6,15,28,53.6,13,16,5,11,23,68,24,2
6830,22,14,10,9,3,10,21,47.6,11,14,0,14,9,31,14,0
6831,15,9,5,10,0,5,13,38.5,8,6,0,6,8,23,16,0
6832,0,0,0,0,0,0,0,0.0,0,0,0,0,0,0,2,0
6833,24,18,17,7,0,15,20,75.0,5,16,9,7,20,44,18,0
6834,13,10,9,1,3,5,8,62.5,3,7,7,0,6,19,22,0
6835,14,10,6,7,1,4,19,21.1,15,5,1,4,4,18,5,0
6836,6,3,4,0,2,3,7,42.9,4,2,0,2,4,10,1,0
6837,2,0,1,1,0,2,4,50.0,2,4,0,4,5,7,2,0
6838,61,39,17,25,19,28,52,53.8,24,34,1,33,22,83,23,0
6839,24,11,6,10,8,11,28,39.3,17,20,1,19,10,34,7,0
6840,0,0,0,0,0,0,0,0.0,0,0,0,0,0,0,1,0
6841,40,26,15,17,8,15,34,44.1,19,33,0,33,4,44,14,0
6842,41,24,17,21,3,21,67,31.3,46,32,6,26,41,82,53,2
6843,6,5,1,3,2,3,7,42.9,4,2,0,2,4,10,3,0
6844,19,9,8,7,4,9,23,39.1,14,23,8,15,12,31,40,0
6845,26,17,19,6,1,12,17,70.6,5,30,20,10,32,58,81,0
6846,28,17,11,13,4,16,21,76.2,5,12,2,10,10,38,27,0
6847,39,22,23,16,0,19,27,70.4,8,35,18,17,45,84,116,0
6848,53,33,36,16,1,35,55,63.6,20,67,44,23,65,118,167,1
6849,36,26,14,15,7,18,41,43.9,23,28,1,27,7,43,6,0
6850,51,31,20,23,8,29,91,31.9,62,40,7,33,23,74,31,0
6851,10,6,6,4,0,5,9,55.6,4,4,0,4,2,12,5,0
6852,5,2,0,5,0,1,2,50.0,1,2,0,2,2,7,4,0
6853,64,41,18,40,6,33,65,50.8,32,29,0,29,10,74,6,0
6854,1,0,0,1,0,1,1,100.0,0,0,0,0,0,1,1,0
6855,2,1,0,2,0,2,4,50.0,2,2,1,1,0,2,2,0
6856,30,19,19,11,0,11,21,52.4,10,18,14,4,23,53,53,0
6857,28,20,12,13,3,9,22,40.9,13,9,2,7,13,41,19,0
6858,66,46,40,21,5,38,63,60.3,25,25,13,12,31,97,86,0
6859,21,14,15,6,0,10,14,71.4,4,25,16,9,35,56,123,1
6860,11,9,7,4,0,4,14,28.6,10,12,2,10,9,20,20,0
6861,4,2,2,1,1,2,6,33.3,4,3,1,2,4,8,7,0
6862,23,14,9,8,6,8,26,30.8,18,18,0,18,10,33,13,0
6863,17,12,15,2,0,12,22,54.5,10,27,18,9,24,41,114,0
6864,53,33,36,13,4,33,55,60.0,22,47,23,24,25,78,154,2
6865,1,1,1,0,0,1,2,50.0,1,2,0,2,1,2,3,0
6866,31,19,23,7,1,16,32,50.0,16,15,8,7,35,66,68,0
6867,2,1,1,0,1,1,9,11.1,8,4,1,3,2,4,15,0
6868,62,40,28,31,3,24,40,60.0,16,25,11,14,46,108,87,2
6869,50,32,25,22,3,28,50,56.0,22,19,9,10,35,85,84,2
6870,21,15,10,11,0,10,20,50.0,10,42,33,9,23,44,131,0
6871,5,4,1,2,2,2,4,50.0,2,2,0,2,0,5,3,0
6872,1,0,0,1,0,0,0,0.0,0,2,0,2,1,2,2,1
6873,38,26,24,13,1,13,19,68.4,6,40,34,6,31,69,166,1
6874,0,0,0,0,0,0,0,0.0,0,0,0,0,1,1,0,0
6875,21,7,4,11,6,3,9,33.3,6,17,1,16,12,33,18,0
6876,29,21,14,10,5,16,25,64.0,9,17,10,7,8,37,48,0
6877,9,6,1,6,2,2,12,16.7,10,16,0,16,5,14,8,0
6878,0,0,0,0,0,0,1,0.0,1,0,0,0,0,0,1,0
6879,23,16,12,11,0,15,46,32.6,31,31,1,30,13,36,6,0
6880,22,11,13,8,1,13,22,59.1,9,11,1,10,3,25,7,1
6881,44,31,14,15,15,24,56,42.9,32,32,6,26,16,60,7,0
6882,42,27,26,14,2,27,48,56.3,21,37,13,24,61,103,104,1
6883,0,0,0,0,0,0,0,0.0,0,0,0,0,0,0,10,0
6884,29,20,22,7,0,11,24,45.8,13,21,8,13,15,44,34,0
6885,7,4,3,4,0,2,4,50.0,2,3,2,1,5,12,10,0
6886,7,2,4,2,1,1,4,25.0,3,5,1,4,3,10,8,0
6887,8,2,5,3,0,5,8,62.5,3,10,2,8,6,14,6,0
6888,0,0,0,0,0,0,2,0.0,2,0,0,0,2,2,2,0
6889,0,0,0,0,0,0,1,0.0,1,0,0,0,1,1,0,0
6890,9,5,5,4,0,2,5,40.0,3,6,4,2,15,24,14,0
6891,2,2,2,0,0,1,2,50.0,1,0,0,0,1,3,12,2
6892,50,34,34,16,0,25,38,65.8,13,58,40,18,35,85,182,1
6893,31,21,10,17,4,17,35,48.6,18,16,7,9,21,52,26,3
6894,5,3,4,1,0,2,5,40.0,3,2,1,1,3,8,14,0
6895,0,0,0,0,0,0,0,0.0,0,0,0,0,0,0,0,0
6896,0,0,0,0,0,0,2,0.0,2,1,0,1,0,0,1,0
6897,5,5,2,2,1,0,6,0.0,6,1,1,0,5,10,3,0
6898,46,24,11,27,8,27,59,45.8,32,32,2,30,27,73,22,0
6899,67,39,42,23,2,24,40,60.0,16,42,13,29,62,129,84,1
6900,1,0,1,0,0,0,0,0.0,0,0,0,0,0,1,0,0
6901,1,0,1,0,0,0,3,0.0,3,1,0,1,0,1,8,0
6902,23,14,9,9,5,7,15,46.7,8,11,3,8,3,26,15,0
6903,57,32,35,18,4,31,43,72.1,12,44,23,21,51,108,100,4
6904,0,0,0,0,0,0,0,0.0,0,1,0,1,1,1,4,1
6905,0,0,0,0,0,0,2,0.0,2,0,0,0,0,0,12,0
6906,31,16,15,8,8,13,34,38.2,21,31,2,29,8,39,11,0
6907,27,17,7,15,5,12,25,48.0,13,9,2,7,16,43,5,1
6908,39,23,16,17,6,22,34,64.7,12,23,5,18,23,62,59,0
6909,55,33,26,15,14,32,54,59.3,22,35,10,25,28,83,73,0
6910,4,4,3,0,1,1,1,100.0,0,2,0,2,0,4,2,0
6911,1,0,1,0,0,1,6,16.7,5,3,1,2,1,2,3,0
6912,0,0,0,0,0,0,0,0.0,0,2,0,2,0,0,5,4
6913,0,0,0,0,0,0,1,0.0,1,4,4,0,1,1,12,0
6914,15,11,4,10,1,3,19,15.8,16,10,1,9,1,16,9,0
6915,74,48,33,37,4,34,70,48.6,36,50,6,44,39,113,34,1
6916,39,23,19,16,4,13,73,17.8,60,35,8,27,32,71,25,2
6917,43,24,10,22,11,17,36,47.2,19,19,2,17,20,63,14,0
6918,28,13,19,8,1,17,34,50.0,17,34,23,11,34,62,103,2
6919,38,26,24,14,0,20,31,64.5,11,30,9,21,17,55,59,0
6920,1,1,0,1,0,0,0,0.0,0,0,0,0,0,1,1,0
6921,17,13,3,11,3,10,27,37.0,17,14,4,10,9,26,15,0
6922,23,17,10,12,1,11,20,55.0,9,6,1,5,16,39,22,0
6923,36,19,14,16,6,11,35,31.4,24,30,6,24,18,54,27,0
6924,53,40,35,18,0,29,44,65.9,15,31,12,19,36,89,140,0
6925,3,3,2,1,0,1,6,16.7,5,8,0,8,11,14,7,0
6926,33,20,18,13,2,24,31,77.4,7,16,7,9,19,52,93,1
6927,26,19,15,9,2,11,25,44.0,14,22,4,18,14,40,18,1
6928,5,4,1,4,0,1,4,25.0,3,4,4,0,4,9,40,0
6929,0,0,0,0,0,0,0,0.0,0,0,0,0,0,0,0,0
6930,1,1,0,1,0,1,4,25.0,3,5,2,3,5,6,9,0
6931,0,0,0,0,0,0,1,0.0,1,1,0,1,2,2,1,0
6932,7,4,4,3,0,3,14,21.4,11,7,3,4,11,18,6,0
6933,4,3,1,1,2,2,7,28.6,5,5,0,5,0,4,10,0
6934,24,9,14,9,1,8,25,32.0,17,42,26,16,21,45,107,1
6935,71,43,29,37,5,26,64,40.6,38,55,16,39,54,125,54,1
6936,7,5,1,5,1,3,8,37.5,5,6,3,3,1,8,7,0
6937,5,3,0,2,3,2,11,18.2,9,3,1,2,3,8,5,0
6938,58,35,31,22,5,29,65,44.6,36,28,11,17,47,105,83,2
6939,29,15,9,16,4,11,26,42.3,15,11,6,5,23,52,23,0
6940,20,10,9,9,2,6,12,50.0,6,22,18,4,16,36,121,0
6941,0,0,0,0,0,0,0,0.0,0,0,0,0,0,0,0,0
6942,34,24,25,6,3,20,32,62.5,12,35,17,18,41,75,104,0
6943,14,10,8,4,2,6,13,46.2,7,7,2,5,7,21,9,0
6944,0,0,0,0,0,0,3,0.0,3,5,0,5,0,0,6,0
6945,19,11,11,7,1,10,18,55.6,8,12,2,10,11,30,12,0
6946,0,0,0,0,0,0,0,0.0,0,0,0,0,0,0,0,0
6947,0,0,0,0,0,0,1,0.0,1,0,0,0,0,0,2,0
6948,29,15,9,13,7,14,32,43.8,18,23,5,18,21,50,20,0
6949,50,36,22,19,9,27,50,54.0,23,55,27,28,60,110,109,0
6950,9,5,4,5,0,4,4,100.0,0,11,9,2,8,17,32,0
6951,11,10,3,6,2,3,11,27.3,8,4,1,3,2,13,11,0
6952,2,0,0,2,0,1,1,100.0,0,1,0,1,1,3,1,0
6953,1,1,0,0,1,1,1,100.0,0,0,0,0,1,2,1,0
6954,1,0,0,1,0,1,4,25.0,3,5,0,5,1,2,4,0
6955,7,5,3,3,1,3,6,50.0,3,4,0,4,1,8,3,0
6956,3,1,0,1,2,3,7,42.9,4,7,3,4,3,6,0,0
6957,59,29,28,26,5,24,48,50.0,24,42,11,31,32,91,85,1
6958,8,5,2,5,1,2,6,33.3,4,4,0,4,4,12,3,0
6959,0,0,0,0,0,0,1,0.0,1,1,0,1,3,3,13,1
6960,15,6,6,7,2,7,16,43.8,9,13,2,11,3,18,3,0
6961,50,30,39,11,0,20,28,71.4,8,19,13,6,29,79,152,0
6962,0,0,0,0,0,0,0,0.0,0,1,0,1,0,0,1,0
6963,28,17,24,3,1,8,8,100.0,0,15,8,7,34,62,78,1
6964,8,4,5,3,0,5,10,50.0,5,2,0,2,3,11,0,0
6965,1,0,1,0,0,0,2,0.0,2,1,0,1,1,2,4,0
6966,29,20,20,7,2,12,19,63.2,7,13,4,9,13,42,35,0
6967,48,25,19,26,3,22,56,39.3,34,40,6,34,22,70,25,0
6968,32,22,21,11,0,14,27,51.9,13,21,6,15,20,52,25,1
6969,23,15,6,12,5,14,37,37.8,23,16,3,13,12,35,9,0
6970,0,0,0,0,0,0,0,0.0,0,0,0,0,0,0,0,0
6971,24,9,17,5,2,13,20,65.0,7,12,7,5,12,36,49,0
6972,10,5,6,4,0,6,10,60.0,4,6,3,3,4,14,6,1
6973,7,4,3,3,1,0,5,0.0,5,6,2,4,2,9,0,0
6974,6,4,2,2,2,3,3,100.0,0,0,0,0,1,7,2,0
6975,23,14,15,7,1,19,34,55.9,15,50,31,19,37,60,162,2
6976,31,22,13,11,7,12,32,37.5,20,13,2,11,13,44,2,0
6977,0,0,0,0,0,0,0,0.0,0,0,0,0,1,1,0,0
6978,4,3,1,2,1,1,5,20.0,4,4,0,4,0,4,1,0
6979,44,30,19,17,8,27,45,60.0,18,42,27,15,39,83,94,1
6980,26,13,19,6,1,12,16,75.0,4,24,10,14,10,36,56,0
6981,11,6,3,7,1,6,11,54.5,5,9,1,8,3,14,7,0
6982,2,1,1,1,0,2,4,50.0,2,2,1,1,1,3,5,0
6983,30,21,18,11,1,18,25,72.0,7,22,14,8,24,54,75,0
6984,48,31,20,26,2,23,40,57.5,17,52,14,38,33,81,94,1
6985,0,0,0,0,0,0,0,0.0,0,0,0,0,0,0,3,0
6986,12,7,4,6,2,7,24,29.2,17,19,3,16,11,23,20,0
6987,5,4,2,1,2,1,4,25.0,3,10,0,10,1,6,4,0
6988,27,17,14,9,4,13,21,61.9,8,8,3,5,11,38,16,0
6989,0,0,0,0,0,0,0,0.0,0,0,0,0,0,0,0,0
6990,17,6,12,5,0,11,13,84.6,2,20,8,12,23,40,91,0
6991,48,28,23,20,5,26,52,50.0,26,26,12,14,20,68,36,0
6992,18,13,10,4,4,12,20,60.0,8,5,3,2,8,26,15,0
6993,0,0,0,0,0,0,2,0.0,2,0,0,0,0,0,14,0
6994,40,22,21,14,5,22,47,46.8,25,34,8,26,31,71,50,0
6995,40,23,18,18,4,20,46,43.5,26,40,11,29,31,71,63,0
6996,11,8,3,7,1,5,12,41.7,7,8,1,7,4,15,4,0
6997,4,3,1,1,2,2,2,100.0,0,2,0,2,3,7,1,0
6998,8,6,0,2,6,1,12,8.3,11,9,3,6,3,11,5,0
6999,13,7,5,6,2,5,13,38.5,8,14,1,13,8,21,7,0
7000,12,9,9,2,1,8,8,100.0,0,5,4,1,6,18,27,0
7001,27,16,16,6,5,9,11,81.8,2,9,0,9,9,36,16,0
7002,21,14,12,9,0,12,27,44.4,15,19,13,6,23,44,65,0
7003,31,22,8,18,5,14,44,31.8,30,18,2,16,4,35,18,0
7004,2,0,1,1,0,0,2,0.0,2,2,0,2,0,2,0,0
7005,4,0,3,1,0,2,6,33.3,4,2,1,1,4,8,3,0
7006,0,0,0,0,0,0,2,0.0,2,0,0,0,0,0,0,0
7007,14,10,5,9,0,9,14,64.3,5,10,2,8,10,24,7,0
7008,88,60,47,35,6,48,80,60.0,32,33,8,25,37,125,69,0
7009,10,8,5,4,1,7,11,63.6,4,11,6,5,4,14,10,0
7010,73,38,32,30,11,39,74,52.7,35,44,5,39,28,101,53,0
7011,19,12,15,4,0,11,16,68.8,5,24,14,10,15,34,96,4
7012,7,3,4,3,0,2,7,28.6,5,7,1,6,0,7,2,0
7013,6,4,4,2,0,2,14,14.3,12,11,0,11,4,10,6,0
7014,11,6,3,4,4,5,12,41.7,7,7,1,6,1,12,1,0
7015,23,12,6,10,7,10,26,38.5,16,18,0,18,17,40,13,0
7016,3,1,1,1,1,2,3,66.7,1,3,0,3,5,8,12,0
7017,6,3,1,2,3,1,9,11.1,8,10,3,7,4,10,3,0
7018,31,18,10,16,5,21,51,41.2,30,25,6,19,13,44,28,0
7019,10,4,3,5,2,5,9,55.6,4,5,0,5,4,14,9,0
7020,32,19,17,13,2,11,19,57.9,8,23,8,15,19,51,43,0
7021,10,8,2,5,3,6,21,28.6,15,6,0,6,5,15,2,0
7022,33,24,18,13,2,12,29,41.4,17,18,7,11,27,60,31,0
7023,17,14,7,8,2,9,11,81.8,2,26,3,23,15,32,36,0
7024,20,11,13,6,1,12,21,57.1,9,23,16,7,25,45,74,1
7025,36,23,19,13,4,23,31,74.2,8,24,4,20,30,66,66,0
7026,15,9,6,6,3,8,19,42.1,11,11,1,10,6,21,10,0
7027,3,2,2,1,0,1,2,50.0,1,1,0,1,1,4,3,0
7028,0,0,0,0,0,0,1,0.0,1,0,0,0,0,0,5,0
7029,0,0,0,0,0,0,0,0.0,0,0,0,0,0,0,6,1
7030,56,37,37,13,6,28,45,62.2,17,34,2,32,24,80,56,0
7031,30,19,18,9,3,17,22,77.3,5,24,6,18,29,59,55,2
7032,48,34,32,14,2,20,31,64.5,11,49,24,25,34,82,98,2
7033,5,3,3,2,0,4,8,50.0,4,4,2,2,8,13,8,0
7034,4,1,1,1,2,2,5,40.0,3,9,2,7,1,5,9,0
7035,4,2,1,1,2,1,6,16.7,5,5,0,5,1,5,4,0
7036,3,1,0,1,2,2,5,40.0,3,6,1,5,4,7,2,0
7037,5,2,3,1,1,2,4,50.0,2,8,0,8,2,7,2,0
7038,52,39,31,18,3,23,33,69.7,10,26,9,17,20,72,36,0
7039,10,5,1,5,4,4,15,26.7,11,14,1,13,2,12,18,0
7040,0,0,0,0,0,0,0,0.0,0,0,0,0,0,0,0,0
7041,9,6,5,3,1,5,10,50.0,5,4,2,2,12,21,29,0
7042,0,0,0,0,0,0,0,0.0,0,0,0,0,0,0,1,1
7043,106,68,62,35,9,55,92,59.8,37,26,5,21,27,133,48,1
7044,21,13,10,9,2,11,22,50.0,11,10,4,6,17,38,36,1
7045,0,0,0,0,0,0,0,0.0,0,0,0,0,0,0,0,0
7046,65,40,37,25,3,26,58,44.8,32,24,9,15,30,95,32,1
7047,29,19,12,13,4,7,25,28.0,18,22,1,21,11,40,22,0
7048,29,18,11,14,4,12,31,38.7,19,11,0,11,4,33,7,0
7049,0,0,0,0,0,0,0,0.0,0,0,0,0,0,0,16,1
7050,55,36,29,23,3,26,61,42.6,35,27,15,12,40,95,91,1
7051,12,7,5,4,3,5,9,55.6,4,8,3,5,1,13,5,0
7052,12,7,5,6,1,3,14,21.4,11,9,0,9,3,15,11,0
7053,2,2,0,0,2,1,5,20.0,4,3,1,2,2,4,9,0
7054,9,5,1,3,5,2,6,33.3,4,7,0,7,2,11,7,0
7055,38,23,22,13,3,18,28,64.3,10,21,11,10,33,71,64,2
7056,4,3,3,1,0,4,4,100.0,0,5,3,2,3,7,18,0
7057,2,1,2,0,0,1,3,33.3,2,0,0,0,3,5,2,0
7058,43,30,25,14,4,20,47,42.6,27,15,2,13,18,61,20,0
7059,13,6,4,5,4,7,14,50.0,7,7,1,6,5,18,1,0
7060,36,23,12,16,8,21,34,61.8,13,18,1,17,13,49,11,0
7061,11,8,5,5,1,5,16,31.3,11,20,2,18,15,26,6,1
7062,33,21,14,11,8,16,40,40.0,24,20,4,16,9,42,6,1
7063,10,7,5,5,0,7,12,58.3,5,5,3,2,2,12,23,1
7064,4,2,1,2,1,2,7,28.6,5,3,1,2,2,6,21,0
7065,89,47,48,32,9,45,70,64.3,25,45,6,39,55,144,57,0
7066,33,25,22,9,2,24,43,55.8,19,24,7,17,22,55,61,3
7067,17,11,6,11,0,5,11,45.5,6,25,20,5,30,47,49,0
7068,0,0,0,0,0,0,0,0.0,0,0,0,0,0,0,0,0
7069,4,3,3,1,0,1,3,33.3,2,8,0,8,3,7,3,0
7070,17,12,5,10,2,5,13,38.5,8,8,1,7,6,23,18,0
7071,16,10,12,4,0,10,18,55.6,8,14,7,7,10,26,46,0
7072,0,0,0,0,0,0,0,0.0,0,0,0,0,0,0,0,0
7073,0,0,0,0,0,0,1,0.0,1,0,0,0,0,0,3,2
7074,10,5,3,5,2,1,13,7.7,12,6,1,5,11,21,9,1
7075,5,2,2,3,0,2,6,33.3,4,5,0,5,1,6,1,0
7076,3,3,1,2,0,2,6,33.3,4,0,0,0,1,4,5,0
7077,12,5,4,6,2,2,19,10.5,17,9,1,8,4,16,6,0
7078,29,17,15,7,7,9,29,31.0,20,5,0,5,6,35,2,0
7079,22,13,11,7,4,13,23,56.5,10,18,1,17,6,28,4,0
7080,0,0,0,0,0,0,1,0.0,1,0,0,0,0,0,3,0
7081,70,42,41,22,7,27,57,47.4,30,64,19,45,38,108,82,0
7082,1,1,0,0,1,1,1,100.0,0,0,0,0,1,2,1,0
7083,20,10,12,6,2,12,30,40.0,18,11,2,9,15,35,11,0
7084,69,44,39,24,6,35,59,59.3,24,38,9,29,34,103,77,2
7085,53,34,33,18,2,20,40,50.0,20,64,51,13,79,132,225,0
7086,48,34,28,16,4,25,34,73.5,9,35,9,26,26,74,111,0
7087,36,20,16,15,5,17,41,41.5,24,30,6,24,3,39,25,0
7088,1,1,0,1,0,0,0,0.0,0,0,0,0,1,2,2,0
7089,1,0,0,1,0,0,1,0.0,1,0,0,0,1,2,2,0
7090,0,0,0,0,0,0,0,0.0,0,0,0,0,0,0,6,0
7091,36,24,25,9,2,17,23,73.9,6,43,27,16,50,86,126,1
7092,1,0,0,0,1,0,1,0.0,1,0,0,0,1,2,0,0
7093,41,32,19,19,3,20,62,32.3,42,29,8,21,27,68,24,0
7094,0,0,0,0,0,0,1,0.0,1,1,0,1,0,0,2,0
7095,2,1,2,0,0,1,1,100.0,0,0,0,0,1,3,1,0
7096,17,11,10,5,2,5,8,62.5,3,10,4,6,8,25,11,0
7097,38,24,14,14,10,14,39,35.9,25,10,1,9,8,46,13,0
7098,5,3,2,3,0,2,5,40.0,3,0,0,0,5,10,2,0
7099,0,0,0,0,0,0,1,0.0,1,2,0,2,0,0,0,0
7100,13,10,5,8,0,9,19,47.4,10,3,0,3,8,21,16,0
7101,20,12,13,6,1,12,19,63.2,7,23,15,8,21,41,45,0
7102,56,32,19,21,16,16,27,59.3,11,16,1,15,15,71,7,0
7103,3,2,1,1,1,2,5,40.0,3,0,0,0,2,5,4,0
7104,39,25,26,11,2,22,45,48.9,23,48,25,23,40,79,138,4
7105,61,38,41,18,2,30,39,76.9,9,27,13,14,15,76,75,2
7106,4,4,2,0,2,3,5,60.0,2,2,0,2,3,7,4,0
7107,5,5,0,3,2,3,6,50.0,3,7,0,7,1,6,6,0
7108,1,0,1,0,0,0,1,0.0,1,2,0,2,1,2,14,6
7109,12,7,3,4,5,5,12,41.7,7,7,0,7,1,13,8,0
7110,36,26,24,12,0,21,36,58.3,15,32,18,14,37,73,115,1
7111,4,4,4,0,0,4,4,100.0,0,0,0,0,0,4,18,4
7112,36,27,22,13,1,20,27,74.1,7,22,15,7,45,81,88,1
7113,0,0,0,0,0,0,1,0.0,1,0,0,0,1,1,3,0
7114,9,6,3,4,2,4,18,22.2,14,13,0,13,8,17,5,0
7115,0,0,0,0,0,0,2,0.0,2,0,0,0,0,0,20,7
7116,1,0,1,0,0,0,0,0.0,0,0,0,0,1,2,0,0
7117,1,0,1,0,0,1,2,50.0,1,0,0,0,0,1,11,3
7118,16,11,8,8,0,5,13,38.5,8,3,0,3,5,21,5,0
7119,12,9,0,5,7,5,7,71.4,2,7,0,7,4,16,1,0
7120,20,13,8,9,3,5,13,38.5,8,8,1,7,17,37,3,1
7121,47,24,18,23,6,24,45,53.3,21,21,3,18,9,56,23,1
7122,45,25,24,16,5,26,39,66.7,13,22,6,16,24,69,33,3
7123,5,3,0,2,3,1,5,20.0,4,13,1,12,2,7,17,0
7124,29,18,10,14,5,15,37,40.5,22,17,1,16,4,33,8,0
7125,15,8,7,7,1,3,15,20.0,12,9,0,9,11,26,5,0
7126,2,1,1,0,1,2,4,50.0,2,4,1,3,0,2,1,0
7127,11,6,0,6,5,4,11,36.4,7,7,0,7,3,14,13,0
7128,0,0,0,0,0,0,1,0.0,1,0,0,0,0,0,1,0
7129,38,27,30,8,0,21,32,65.6,11,25,18,7,34,72,92,1
7130,7,4,3,2,2,5,9,55.6,4,6,0,6,3,10,1,0
7131,32,17,8,16,8,10,31,32.3,21,20,3,17,17,49,34,1
7132,63,36,20,35,8,34,70,48.6,36,34,7,27,38,101,42,0
7133,32,19,16,12,4,20,34,58.8,14,17,1,16,16,48,28,0
7134,44,27,22,15,7,21,42,50.0,21,24,6,18,23,67,31,0
7135,3,3,1,0,2,1,7,14.3,6,5,1,4,1,4,0,0
7136,30,13,10,15,5,16,45,35.6,29,17,2,15,9,39,7,0
7137,18,16,6,7,5,8,20,40.0,12,24,5,19,16,34,21,0
7138,5,3,0,3,2,0,3,0.0,3,5,0,5,1,6,7,0
7139,23,14,14,8,1,14,22,63.6,8,28,22,6,32,55,86,0
7140,33,21,18,9,6,8,30,26.7,22,12,2,10,11,44,19,0
7141,0,0,0,0,0,0,1,0.0,1,0,0,0,0,0,4,1
7142,16,12,11,4,1,9,11,81.8,2,3,0,3,5,21,18,0
7143,29,16,14,11,4,10,25,40.0,15,13,3,10,9,38,5,1
7144,3,2,2,1,0,0,3,0.0,3,3,0,3,3,6,3,0
7145,6,2,3,1,2,2,5,40.0,3,2,1,1,0,6,0,0
7146,10,5,3,6,1,3,7,42.9,4,10,6,4,16,26,10,0
7147,16,7,6,8,2,5,12,41.7,7,9,1,8,10,26,6,0
7148,0,0,0,0,0,0,0,0.0,0,1,1,0,0,0,0,0
7149,13,6,2,8,3,6,15,40.0,9,11,2,9,5,18,9,0
7150,13,9,2,7,4,4,10,40.0,6,15,1,14,6,19,11,0
7151,21,11,8,12,1,9,26,34.6,17,9,1,8,9,30,10,0
7152,6,4,1,5,0,3,5,60.0,2,6,2,4,6,12,7,0
7153,3,1,0,2,1,0,3,0.0,3,1,0,1,0,3,0,0
7154,42,21,17,22,3,16,32,50.0,16,22,7,15,18,60,33,0
7155,0,0,0,0,0,0,1,0.0,1,0,0,0,0,0,0,0
7156,35,23,12,21,2,15,22,68.2,7,22,3,19,8,43,14,0
7157,15,9,9,6,0,7,9,77.8,2,11,9,2,14,29,59,0
7158,50,28,26,19,5,20,45,44.4,25,19,4,15,28,78,60,0
7159,13,4,2,6,5,3,11,27.3,8,9,3,6,1,14,9,0
7160,5,1,2,2,1,3,7,42.9,4,9,5,4,5,10,15,0
7161,26,16,13,10,3,11,28,39.3,17,9,3,6,13,39,23,0
7162,11,6,5,5,1,7,9,77.8,2,9,7,2,7,18,23,0
7163,2,1,2,0,0,1,1,100.0,0,0,0,0,0,2,2,0
7164,3,1,0,3,0,3,3,100.0,0,0,0,0,1,4,0,0
7165,26,15,10,11,5,15,25,60.0,10,14,2,12,13,39,15,0
7166,19,10,8,10,1,9,21,42.9,12,14,3,11,12,31,23,0
7167,64,42,27,27,10,33,76,43.4,43,41,11,30,16,80,29,0
7168,9,4,0,6,3,0,12,0.0,12,27,2,25,7,16,23,0
7169,27,17,9,14,4,9,20,45.0,11,14,1,13,5,32,7,1
7170,5,2,2,3,0,2,14,14.3,12,12,1,11,9,14,8,0
7171,30,18,7,18,5,13,38,34.2,25,23,2,21,10,40,12,0
7172,13,6,5,8,0,7,10,70.0,3,5,2,3,4,17,7,0
7173,6,4,6,0,0,4,5,80.0,1,3,1,2,3,9,12,0
7174,24,15,11,10,3,12,35,34.3,23,23,6,17,14,38,15,0
7175,10,9,6,4,0,8,15,53.3,7,8,1,7,6,16,6,1
7176,7,6,1,4,2,2,5,40.0,3,3,2,1,4,11,2,0
7177,1,1,1,0,0,1,1,100.0,0,1,1,0,0,1,2,0
7178,8,8,4,3,1,3,8,37.5,5,9,0,9,4,12,0,0
7179,1,0,0,1,0,0,5,0.0,5,3,0,3,3,4,0,0
7180,14,9,11,3,0,10,14,71.4,4,9,6,3,12,26,42,0
7181,5,4,0,3,2,3,6,50.0,3,8,4,4,1,6,17,0
7182,0,0,0,0,0,0,0,0.0,0,0,0,0,0,0,0,0
7183,10,7,5,3,2,4,11,36.4,7,10,4,6,3,13,13,0
7184,5,3,2,1,2,1,8,12.5,7,9,1,8,3,8,5,0
7185,0,0,0,0,0,0,0,0.0,0,0,0,0,0,0,0,0
7186,0,0,0,0,0,0,0,0.0,0,0,0,0,0,0,0,0
7187,11,7,5,5,1,6,13,46.2,7,14,0,14,3,14,9,0
7188,57,37,44,12,1,31,57,54.4,26,26,12,14,44,101,123,1
7189,2,0,2,0,0,1,3,33.3,2,0,0,0,1,3,14,1
7190,11,5,4,2,5,4,12,33.3,8,24,0,24,4,15,5,0
7191,33,18,7,18,8,10,34,29.4,24,13,4,9,16,49,10,0
7192,36,19,10,13,13,16,32,50.0,16,41,3,38,6,42,7,0
7193,2,1,1,0,1,1,1,100.0,0,1,0,1,0,2,0,0
7194,0,0,0,0,0,0,0,0.0,0,1,1,0,0,0,0,0
7195,10,4,5,3,2,4,11,36.4,7,18,5,13,5,15,10,0
7196,0,0,0,0,0,0,0,0.0,0,0,0,0,0,0,0,0
7197,5,4,2,3,0,2,4,50.0,2,6,4,2,15,20,22,0
7198,62,36,12,43,7,23,48,47.9,25,34,8,26,37,99,22,0
7199,0,0,0,0,0,0,0,0.0,0,0,0,0,0,0,0,0
7200,12,7,2,4,6,4,11,36.4,7,9,2,7,2,14,20,0
7201,0,0,0,0,0,0,0,0.0,0,0,0,0,0,0,2,0
7202,59,36,26,25,8,25,51,49.0,26,24,10,14,32,91,53,1
7203,21,15,8,8,5,13,24,54.2,11,6,2,4,6,27,7,0
7204,21,12,8,12,1,8,20,40.0,12,18,3,15,11,32,38,0
7205,45,27,26,17,2,28,34,82.4,6,44,27,17,20,65,85,2
7206,51,33,38,12,1,19,32,59.4,13,32,23,9,37,88,158,1
7207,1,0,0,0,1,0,0,0.0,0,0,0,0,0,1,0,0
7208,21,11,4,8,9,9,21,42.9,12,14,0,14,5,26,0,0
7209,5,4,1,4,0,5,7,71.4,2,1,0,1,3,8,4,0
7210,4,1,2,2,0,3,7,42.9,4,7,1,6,1,5,5,0
7211,1,1,0,0,1,0,0,0.0,0,3,1,2,1,2,3,0
7212,16,10,7,4,5,3,6,50.0,3,13,1,12,3,19,11,0
7213,24,12,10,8,6,13,28,46.4,15,22,6,16,13,37,17,0
7214,23,15,8,10,5,9,24,37.5,15,19,2,17,3,26,7,0
7215,6,3,3,2,1,2,9,22.2,7,4,0,4,1,7,4,0
7216,6,4,1,3,2,3,9,33.3,6,8,0,8,1,7,4,0
7217,52,33,36,14,2,23,40,57.5,17,27,7,20,31,83,60,1
7218,0,0,0,0,0,0,0,0.0,0,0,0,0,0,0,0,0
7219,22,16,9,9,4,10,25,40.0,15,23,4,19,5,27,35,0
7220,2,1,2,0,0,2,3,66.7,1,0,0,0,0,2,7,0
7221,7,6,5,2,0,4,8,50.0,4,4,2,2,11,18,21,1
7222,40,24,25,12,3,28,61,45.9,33,21,6,15,22,62,49,0
7223,0,0,0,0,0,0,0,0.0,0,0,0,0,0,0,0,0
7224,3,3,2,1,0,1,2,50.0,1,0,0,0,0,3,0,0
7225,71,44,28,39,4,36,89,40.4,53,29,5,24,54,125,42,3
7226,30,16,13,8,9,15,44,34.1,29,29,2,27,15,45,11,0
7227,14,7,7,5,2,2,11,18.2,9,14,4,10,10,24,12,0
7228,18,10,9,6,3,2,12,16.7,10,11,0,11,8,26,2,0
7229,18,13,9,6,3,14,26,53.8,12,15,3,12,8,26,20,1
7230,0,0,0,0,0,0,1,0.0,1,0,0,0,0,0,0,0
7231,30,17,21,8,1,22,39,56.4,17,28,5,23,25,55,64,1
7232,22,15,7,9,6,6,13,46.2,7,24,2,22,7,29,21,0
7233,26,17,17,6,3,13,21,61.9,8,20,3,17,12,38,32,1
7234,17,10,11,5,1,6,9,66.7,3,14,10,4,15,32,45,0
7235,9,7,5,3,1,8,15,53.3,7,10,5,5,18,27,35,0
7236,21,13,14,6,1,12,16,75.0,4,9,6,3,11,32,38,0
7237,34,20,22,11,1,23,37,62.2,14,22,8,14,21,55,46,0
7238,6,2,2,3,1,1,3,33.3,2,13,2,11,6,12,21,0
7239,2,0,1,1,0,2,2,100.0,0,0,0,0,0,2,2,0
7240,0,0,0,0,0,0,0,0.0,0,0,0,0,0,0,0,0
7241,73,46,43,27,3,39,57,68.4,18,40,8,32,30,103,71,0
7242,27,17,8,11,8,10,30,33.3,20,27,4,23,8,35,37,0
7243,0,0,0,0,0,0,1,0.0,1,3,1,2,2,2,1,0
7244,10,6,6,3,1,5,10,50.0,5,3,0,3,1,11,10,0
7245,37,23,22,10,5,21,28,75.0,7,38,19,19,41,78,95,0
7246,15,6,13,2,0,8,14,57.1,6,9,2,7,13,28,52,0
7247,19,14,13,5,1,12,15,80.0,3,19,15,4,31,50,75,1
7248,42,25,17,17,8,18,56,32.1,38,33,4,29,31,73,6,0
7249,1,0,1,0,0,1,2,50.0,1,0,0,0,0,1,24,3
7250,65,42,41,22,2,29,37,78.4,8,33,15,18,34,99,88,1
7251,8,3,1,3,4,1,20,5.0,19,14,2,12,5,13,20,0
7252,0,0,0,0,0,0,0,0.0,0,0,0,0,0,0,2,0
7253,2,2,1,0,1,2,2,100.0,0,0,0,0,0,2,0,0
7254,78,51,28,33,17,34,74,45.9,40,42,6,36,26,104,32,1
7255,4,4,2,1,1,1,6,16.7,5,1,0,1,6,10,1,0
7256,5,3,3,0,2,2,6,33.3,4,3,0,3,1,6,1,0
7257,3,2,1,0,2,1,8,12.5,7,3,2,1,2,5,10,0
7258,1,1,1,0,0,0,2,0.0,2,3,0,3,2,3,2,0
7259,0,0,0,0,0,0,0,0.0,0,0,0,0,0,0,0,0
7260,40,24,30,5,5,24,37,64.9,13,31,16,15,33,73,105,1
7261,4,3,2,2,0,3,3,100.0,0,3,1,2,2,6,0,0
7262,3,2,1,1,1,0,3,0.0,3,3,0,3,1,4,2,0
7263,16,12,9,4,3,12,21,57.1,9,9,6,3,7,23,45,1
7264,0,0,0,0,0,0,0,0.0,0,2,2,0,0,0,0,0
7265,28,17,13,13,2,11,24,45.8,13,23,9,14,20,48,58,2
7266,0,0,0,0,0,0,0,0.0,0,0,0,0,0,0,0,0
7267,8,5,3,5,0,6,11,54.5,5,10,2,8,9,17,12,0
7268,74,47,22,49,3,34,53,64.2,19,18,6,12,19,93,33,0
7269,51,35,15,26,10,21,58,36.2,37,44,8,36,27,78,27,0
7270,1,0,1,0,0,0,0,0.0,0,1,1,0,0,1,0,0
7271,29,14,10,15,4,19,40,47.5,21,13,1,12,13,42,6,0
7272,8,5,5,2,1,7,9,77.8,2,8,1,7,2,10,7,0
7273,28,15,2,22,4,6,12,50.0,6,18,5,13,5,33,33,0
7274,1,1,1,0,0,0,1,0.0,1,0,0,0,2,3,3,0
7275,1,1,0,0,1,1,2,50.0,1,2,0,2,0,1,1,0
7276,46,29,24,19,3,28,57,49.1,29,19,2,17,19,65,37,1
7277,0,0,0,0,0,0,1,0.0,1,1,0,1,0,0,0,0
7278,27,20,8,15,4,15,40,37.5,25,17,4,13,19,46,17,0
7279,27,14,18,8,1,10,17,58.8,7,17,8,9,19,46,53,2
7280,9,5,8,1,0,6,12,50.0,6,17,8,9,11,20,58,0
7281,44,27,13,20,11,21,50,42.0,29,43,6,37,24,68,11,1
7282,8,2,5,2,1,5,10,50.0,5,8,2,6,2,10,10,1
7283,4,4,3,1,0,3,8,37.5,5,2,2,0,5,9,16,0
7284,15,11,12,3,0,8,17,47.1,9,28,22,6,34,49,114,1
7285,7,5,1,3,3,6,9,66.7,3,2,1,1,0,7,5,0
7286,1,1,0,0,1,1,2,50.0,1,1,0,1,2,3,0,0
7287,11,7,4,7,0,2,7,28.6,5,8,0,8,4,15,2,0
7288,7,6,3,2,2,3,5,60.0,2,0,0,0,1,8,0,0
7289,8,4,6,1,1,5,14,35.7,9,8,1,7,2,10,3,0
7290,1,1,1,0,0,0,1,0.0,1,2,0,2,0,1,15,2
7291,5,3,0,3,2,1,6,16.7,5,9,0,9,5,10,2,0
7292,1,1,0,1,0,0,0,0.0,0,0,0,0,2,3,2,0
7293,0,0,0,0,0,0,4,0.0,4,1,0,1,3,3,14,2
7294,4,2,3,1,0,2,6,33.3,4,9,8,1,5,9,23,0
7295,70,42,34,32,4,29,44,65.9,15,64,36,28,64,134,111,0
7296,14,10,9,4,1,5,13,38.5,8,22,17,5,13,27,102,1
7297,11,7,8,3,0,6,10,60.0,4,5,3,2,2,13,15,1
7298,0,0,0,0,0,0,3,0.0,3,0,0,0,0,0,0,0
7299,26,14,13,10,3,11,26,42.3,15,22,2,20,7,33,12,0
7300,2,0,2,0,0,0,0,0.0,0,0,0,0,0,2,4,1
7301,68,41,36,22,10,35,47,74.5,12,35,13,22,40,108,56,2
7302,2,1,1,1,0,2,2,100.0,0,0,0,0,0,2,5,0
7303,5,2,0,3,2,4,4,100.0,0,3,0,3,1,6,2,0
7304,0,0,0,0,0,0,1,0.0,1,0,0,0,0,0,0,0
7305,1,1,1,0,0,1,2,50.0,1,1,0,1,1,2,1,0
7306,7,3,2,4,1,2,6,33.3,4,7,1,6,2,9,9,0
7307,3,0,1,1,1,1,8,12.5,7,6,3,3,1,4,10,1
7308,0,0,0,0,0,0,0,0.0,0,1,0,1,0,0,1,0
7309,2,2,1,1,0,0,1,0.0,1,4,0,4,1,3,1,0
7310,0,0,0,0,0,0,0,0.0,0,0,0,0,0,0,3,0
7311,0,0,0,0,0,0,0,0.0,0,1,0,1,0,0,0,0
7312,22,11,9,8,5,14,53,26.4,39,20,2,18,14,36,5,0
7313,5,3,2,3,0,2,3,66.7,1,2,0,2,3,8,3,0
7314,10,9,8,1,1,2,7,28.6,5,3,1,2,3,13,2,0
7315,1,1,1,0,0,1,2,50.0,1,0,0,0,0,1,3,1
7316,1,1,1,0,0,1,1,100.0,0,0,0,0,0,1,7,1
7317,42,31,15,24,3,18,39,46.2,21,24,6,18,18,60,20,0
7318,58,32,16,36,6,33,64,51.6,31,39,3,36,42,100,59,1
7319,31,18,11,15,5,9,31,29.0,22,26,1,25,24,55,25,0
7320,8,6,2,2,4,1,8,12.5,7,9,0,9,3,11,10,0
7321,58,35,27,23,8,21,64,32.8,43,34,16,18,27,85,38,0
7322,19,13,4,6,9,7,19,36.8,12,18,2,16,6,25,5,0
7323,0,0,0,0,0,0,0,0.0,0,0,0,0,0,0,0,0
7324,12,7,5,2,5,3,8,37.5,5,12,2,10,13,25,16,0
7325,27,13,6,15,6,6,25,24.0,19,31,3,28,13,40,5,0
7326,47,32,26,13,8,23,35,65.7,12,35,12,23,28,75,52,0
7327,30,15,14,15,1,14,27,51.9,13,25,6,19,23,53,19,1
7328,37,20,15,15,7,19,32,59.4,13,27,5,22,15,52,16,0
7329,31,17,18,12,1,11,19,57.9,8,29,25,4,30,61,102,1
7330,37,20,15,19,3,24,40,60.0,16,29,6,23,28,65,56,0
7331,1,1,0,0,1,1,1,100.0,0,0,0,0,0,1,0,0
7332,3,2,1,2,0,1,5,20.0,4,5,0,5,0,3,0,0
7333,0,0,0,0,0,0,3,0.0,3,2,2,0,7,7,17,0
7334,37,26,11,18,8,16,38,42.1,22,29,1,28,11,48,19,0
7335,40,25,15,22,3,22,51,43.1,29,24,6,18,22,62,31,1
7336,3,2,1,2,0,0,2,0.0,2,0,0,0,0,3,0,0
7337,18,8,5,6,7,10,17,58.8,7,15,1,14,7,25,1,0
7338,10,8,2,4,4,3,6,50.0,3,3,0,3,2,12,2,0
7339,40,31,29,11,0,18,35,51.4,17,45,32,13,36,76,120,0
7340,8,5,3,3,2,2,8,25.0,6,7,0,7,1,9,14,0
7341,5,1,2,1,2,1,9,11.1,8,19,5,14,0,5,22,0
7342,5,4,1,2,2,3,7,42.9,4,3,0,3,0,5,0,0
7343,34,24,15,17,2,20,31,64.5,11,26,15,11,22,56,70,0
7344,52,27,26,22,4,24,54,44.4,30,25,4,21,30,82,43,0
7345,15,10,6,4,5,7,27,25.9,20,14,0,14,9,24,5,1
7346,2,2,2,0,0,1,1,100.0,0,0,0,0,0,2,2,0
7347,21,16,9,9,3,4,15,26.7,11,24,4,20,15,36,13,0
7348,2,1,1,1,0,1,3,33.3,2,1,0,1,1,3,1,0
7349,5,5,1,3,1,2,6,33.3,4,5,2,3,2,7,5,0
7350,38,28,15,14,9,22,45,48.9,23,45,0,45,18,56,8,0
7351,0,0,0,0,0,0,0,0.0,0,0,0,0,0,0,0,0
7352,6,5,4,2,0,2,10,20.0,8,8,2,6,8,14,26,0
7353,20,11,11,8,1,10,13,76.9,3,10,2,8,3,23,8,0
7354,27,19,16,10,1,10,17,58.8,7,19,11,8,32,59,109,1
7355,44,25,33,10,1,18,26,69.2,8,34,11,23,40,84,80,0
7356,16,11,4,6,6,7,25,28.0,18,16,0,16,12,28,2,2
7357,4,2,3,0,1,3,8,37.5,5,3,0,3,7,11,3,0
7358,28,19,15,9,4,11,25,44.0,14,20,2,18,13,41,28,0
7359,8,4,1,3,4,3,6,50.0,3,6,0,6,2,10,1,0
7360,0,0,0,0,0,0,0,0.0,0,0,0,0,0,0,0,0
7361,25,13,12,11,2,16,32,50.0,16,10,0,10,23,48,23,1
7362,72,37,35,30,7,30,81,37.0,51,58,26,32,32,104,51,1
7363,4,2,1,3,0,1,4,25.0,3,3,1,2,3,7,5,0
7364,35,24,16,18,1,13,34,38.2,21,14,7,7,17,52,14,1
7365,29,17,20,7,2,14,22,63.6,8,21,10,11,27,56,43,0
7366,3,2,2,1,0,3,4,75.0,1,1,1,0,5,8,4,0
7367,29,19,5,13,11,8,12,66.7,4,21,5,16,6,35,27,0
7368,67,37,26,31,10,22,46,47.8,24,36,6,30,15,82,28,0
7369,9,6,1,8,0,4,14,28.6,10,3,2,1,8,17,7,0
7370,8,5,2,6,0,2,6,33.3,4,1,0,1,3,11,3,0
7371,11,6,2,8,1,7,14,50.0,7,5,0,5,4,15,1,0
7372,4,2,0,3,1,0,4,0.0,4,1,1,0,0,4,3,0
7373,6,4,2,1,3,2,3,66.7,1,3,0,3,3,9,1,0
7374,46,29,35,7,4,27,44,61.4,17,33,17,16,43,89,146,0
7375,41,24,20,15,6,21,37,56.8,16,22,3,19,10,51,24,0
7376,1,1,0,1,0,0,2,0.0,2,6,2,4,3,4,7,0
7377,6,3,2,2,2,3,3,100.0,0,4,3,1,0,6,5,0
7378,5,4,4,0,1,4,11,36.4,7,7,3,4,1,6,5,0
7379,7,4,1,4,2,4,7,57.1,3,3,0,3,7,14,3,0
7380,1,1,1,0,0,1,1,100.0,0,0,0,0,2,3,2,0
7381,72,41,40,28,4,32,62,51.6,30,43,10,33,46,118,39,0
7382,2,2,1,1,0,0,0,0.0,0,1,0,1,0,2,1,0
7383,77,48,20,48,9,36,65,55.4,29,23,2,21,25,102,8,0
7384,48,36,35,10,3,31,40,77.5,9,18,10,8,39,87,70,0
7385,0,0,0,0,0,0,1,0.0,1,2,0,2,0,0,0,0
7386,40,25,13,22,5,20,39,51.3,19,38,6,32,10,50,17,0
7387,23,14,7,13,3,11,29,37.9,18,13,2,11,11,34,10,0
7388,25,14,16,6,3,12,21,57.1,9,22,5,17,23,48,44,0
7389,20,9,7,12,1,9,22,40.9,13,5,1,4,10,30,7,1
7390,4,3,0,3,1,2,4,50.0,2,3,1,2,1,5,2,0
7391,34,20,8,16,10,13,29,44.8,16,29,2,27,9,43,18,0
7392,2,1,1,1,0,0,1,0.0,1,4,1,3,4,6,3,0
7393,0,0,0,0,0,0,1,0.0,1,0,0,0,0,0,0,0
7394,1,0,1,0,0,1,1,100.0,0,0,0,0,1,2,5,2
7395,43,26,25,15,3,13,38,34.2,25,20,5,15,27,70,33,0
7396,0,0,0,0,0,0,3,0.0,3,0,0,0,0,0,8,0
7397,3,2,1,2,0,1,2,50.0,1,5,2,3,7,10,11,0
7398,10,6,5,5,0,4,12,33.3,8,6,1,5,2,12,2,1
7399,8,3,3,4,1,5,17,29.4,12,6,2,4,4,12,3,0
7400,36,20,16,16,4,17,44,38.6,27,19,4,15,12,48,15,0
7401,21,17,4,14,3,9,23,39.1,14,31,4,27,8,29,8,1
7402,12,7,4,5,3,3,11,27.3,8,5,0,5,0,12,5,0
7403,21,15,7,10,4,8,14,57.1,6,7,0,7,16,37,15,1
7404,6,3,3,2,1,1,7,14.3,6,8,0,8,1,7,1,0
7405,1,0,1,0,0,1,2,50.0,1,0,0,0,0,1,6,2
7406,0,0,0,0,0,0,2,0.0,2,2,0,2,0,0,3,0
7407,40,22,12,20,8,16,39,41.0,23,29,4,25,20,60,29,0
7408,1,1,1,0,0,0,0,0.0,0,0,0,0,0,1,0,0
7409,12,9,3,6,3,3,7,42.9,4,9,1,8,6,18,5,0
7410,1,0,0,1,0,0,1,0.0,1,0,0,0,1,2,1,0
7411,32,18,17,10,5,13,30,43.3,17,26,4,22,16,48,13,0
7412,10,5,6,2,2,5,14,35.7,9,6,2,4,5,15,7,0
7413,6,3,1,1,4,0,7,0.0,7,13,4,9,1,7,22,0
7414,16,12,3,11,2,8,17,47.1,9,8,3,5,5,21,10,0
7415,9,3,9,0,0,4,9,44.4,5,12,9,3,14,23,60,0
7416,20,9,11,8,1,7,16,43.8,9,14,9,5,16,36,86,0
7417,9,8,5,3,1,3,5,60.0,2,12,8,4,10,19,30,0
7418,3,2,2,1,0,1,3,33.3,2,8,6,2,5,8,15,0
7419,0,0,0,0,0,0,0,0.0,0,0,0,0,0,0,1,0
7420,0,0,0,0,0,0,0,0.0,0,0,0,0,0,0,0,0
7421,17,11,3,9,5,7,20,35.0,13,18,2,16,8,25,5,0
7422,17,14,6,10,1,8,26,30.8,18,13,2,11,18,35,15,0
7423,18,12,15,3,0,12,19,63.2,7,22,15,7,13,31,67,0
7424,45,25,15,21,9,16,39,41.0,23,27,10,17,20,65,37,0
7425,5,7,2,2,1,3,8,37.5,5,14,0,14,7,12,3,0
7426,19,13,5,10,4,7,30,23.3,23,25,0,25,7,26,18,0
7427,27,23,13,11,3,17,25,68.0,8,15,5,10,25,52,43,0
7428,19,12,9,6,4,12,27,44.4,15,9,0,9,2,21,7,0
7429,11,4,1,4,6,2,9,22.2,7,20,1,19,8,19,19,0
7430,19,14,7,8,4,11,26,42.3,15,13,0,13,11,30,13,0
7431,71,43,46,21,4,44,87,50.6,43,31,7,24,44,115,64,0
7432,3,3,3,0,0,1,1,100.0,0,2,0,2,0,3,0,0
7433,24,14,18,6,0,16,33,48.5,17,25,14,11,21,45,63,0
7434,0,0,0,0,0,0,3,0.0,3,0,0,0,0,0,24,3
7435,59,29,36,22,1,33,60,55.0,27,53,30,23,34,93,79,1
7436,13,8,12,1,0,5,10,50.0,5,5,4,1,6,19,29,0
7437,1,1,1,0,0,0,2,0.0,2,0,0,0,0,1,21,3
7438,71,52,39,21,11,43,77,55.8,34,51,13,38,39,110,86,0
7439,9,6,5,4,0,7,16,43.8,9,14,1,13,6,15,8,0
7440,19,10,15,2,2,13,20,65.0,7,18,11,7,17,36,72,0
7441,16,11,4,9,3,11,15,73.3,4,27,9,18,2,18,8,0
7442,2,0,0,1,1,0,1,0.0,1,0,0,0,1,3,0,0
7443,0,0,0,0,0,0,1,0.0,1,0,0,0,0,0,21,0
7444,0,0,0,0,0,0,0,0.0,0,0,0,0,0,0,0,0
7445,68,46,31,32,5,34,73,46.6,39,29,10,19,33,101,36,0
7446,14,7,1,8,5,3,10,30.0,7,11,2,9,3,17,10,0
7447,60,39,17,32,11,22,38,57.9,16,31,10,21,47,107,22,0
7448,72,40,37,26,9,45,69,65.2,24,32,8,24,33,105,45,0
7449,17,9,2,15,0,12,30,40.0,18,7,3,4,18,35,26,1
7450,14,8,7,5,2,5,19,26.3,14,8,0,8,8,22,12,0
7451,60,41,25,27,8,30,61,49.2,31,45,11,34,25,85,29,0
7452,0,0,0,0,0,0,0,0.0,0,1,0,1,0,0,15,0
7453,52,27,28,15,9,27,50,54.0,23,24,6,18,13,65,21,0
7454,0,0,0,0,0,0,0,0.0,0,0,0,0,0,0,0,0
7455,17,13,8,7,2,7,26,26.9,19,14,2,12,11,28,19,0
7456,55,37,25,26,4,24,56,42.9,32,44,23,21,32,87,59,0
7457,2,1,1,1,0,2,2,100.0,0,1,1,0,0,2,3,0
7458,8,2,0,3,5,3,15,20.0,12,13,2,11,5,13,10,0
7459,1,1,0,0,1,0,0,0.0,0,0,0,0,0,1,0,0
7460,16,10,2,9,5,5,14,35.7,9,9,2,7,6,22,19,0
7461,40,26,32,8,0,31,38,81.6,7,45,35,10,35,75,128,0
7462,41,26,32,7,2,23,44,52.3,21,35,9,26,19,60,42,1
7463,37,20,10,18,9,23,39,59.0,16,20,5,15,8,45,22,0
7464,2,2,1,1,0,1,9,11.1,8,6,0,6,2,4,0,0
7465,0,0,0,0,0,0,1,0.0,1,0,0,0,0,0,0,0
7466,25,17,13,12,0,14,27,51.9,13,20,11,9,29,54,72,2
7467,43,28,18,20,5,18,30,60.0,12,20,4,16,28,71,49,0
7468,26,16,21,5,0,14,22,63.6,8,16,6,10,18,44,32,0
7469,15,8,7,5,3,7,9,77.8,2,3,0,3,6,21,8,0
7470,0,0,0,0,0,0,4,0.0,4,1,1,0,0,0,3,0
7471,25,14,10,12,3,11,42,26.2,31,19,4,15,12,37,19,0
7472,24,15,8,10,6,8,22,36.4,14,14,3,11,4,28,6,0
7473,25,13,18,6,1,18,38,47.4,20,28,18,10,15,40,90,2
7474,4,3,0,3,1,0,0,0.0,0,1,0,1,1,5,2,0
7475,11,5,1,5,5,1,7,14.3,6,6,0,6,0,11,3,0
7476,40,23,22,14,4,23,32,71.9,9,29,5,24,14,54,49,0
7477,72,49,43,22,7,42,62,67.7,20,31,8,23,35,107,37,0
7478,9,6,1,5,3,3,6,50.0,3,3,0,3,1,10,6,0
7479,21,12,10,7,4,13,27,48.1,14,13,0,13,11,32,3,0
7480,11,7,4,7,0,4,15,26.7,11,7,3,4,8,19,9,0
7481,61,33,25,31,5,33,62,53.2,29,31,1,30,14,75,31,1
7482,50,27,27,17,6,30,50,60.0,20,24,5,19,27,77,64,1
7483,35,21,14,19,2,18,33,54.5,15,25,3,22,26,61,27,0
7484,51,32,17,25,9,22,43,51.2,21,29,2,27,7,58,14,0
7485,49,30,21,25,3,33,67,49.3,34,47,15,32,34,83,69,1
7486,7,4,5,2,0,4,5,80.0,1,4,0,4,2,9,1,0
7487,6,5,3,3,0,0,4,0.0,4,4,0,4,3,9,12,0
7488,43,23,15,21,7,24,50,48.0,26,23,3,20,27,70,29,0
7489,7,5,4,1,2,2,9,22.2,7,2,0,2,3,10,9,0
7490,42,26,21,16,5,28,59,47.5,31,29,9,20,28,70,73,2
7491,1,0,0,1,0,0,1,0.0,1,2,0,2,1,2,1,0
7492,0,0,0,0,0,0,1,0.0,1,0,0,0,0,0,13,0
7493,15,12,6,9,0,5,8,62.5,3,10,1,9,7,22,14,0
7494,5,2,0,1,4,0,3,0.0,3,2,1,1,0,5,1,0
7495,0,0,0,0,0,0,2,0.0,2,0,0,0,1,1,18,4
7496,0,0,0,0,0,0,1,0.0,1,2,0,2,0,0,0,0
7497,10,6,7,2,1,3,6,50.0,3,10,8,2,7,17,59,1
7498,16,11,9,7,0,9,12,75.0,3,26,19,7,17,33,72,0
7499,16,11,9,7,0,2,14,14.3,12,16,9,7,18,34,74,2
7500,7,6,2,3,2,2,7,28.6,5,1,0,1,0,7,0,0
7501,12,5,5,4,3,4,5,80.0,1,2,0,2,2,14,1,0
7502,16,12,15,1,0,6,9,66.7,3,20,14,6,39,55,77,0
7503,8,7,1,3,4,4,6,66.7,2,3,0,3,1,9,2,0
7504,6,1,5,1,0,4,6,66.7,2,6,5,1,9,15,24,0
7505,38,20,18,11,9,21,47,44.7,26,42,6,36,16,54,23,0
7506,93,54,37,44,12,40,87,46.0,47,45,8,37,33,126,83,0
7507,31,16,17,13,1,22,38,57.9,16,20,5,15,17,48,23,0
7508,8,8,1,4,3,1,6,16.7,5,5,0,5,2,10,5,0
7509,7,7,1,2,4,2,5,40.0,3,13,2,11,4,11,7,0
7510,12,9,2,6,4,1,9,11.1,8,9,1,8,1,13,17,0
7511,1,1,0,0,1,0,4,0.0,4,1,0,1,2,3,1,0
7512,0,0,0,0,0,0,0,0.0,0,0,0,0,0,0,0,0
7513,7,5,4,2,1,4,8,50.0,4,2,0,2,0,7,2,0
7514,15,8,5,5,5,4,11,36.4,7,6,0,6,3,18,5,0
7515,0,0,0,0,0,0,0,0.0,0,0,0,0,0,0,0,0
7516,14,11,5,7,2,4,14,28.6,10,12,0,12,9,23,7,0
7517,12,8,4,7,1,2,7,28.6,5,7,0,7,2,14,1,0
7518,22,13,2,14,6,10,17,58.8,7,21,2,19,5,27,3,0
7519,0,0,0,0,0,0,0,0.0,0,0,0,0,0,0,0,0
7520,11,7,6,4,1,4,7,57.1,3,3,2,1,5,16,15,0
7521,31,18,19,11,1,23,49,46.9,26,26,15,11,32,63,86,2
7522,2,1,1,1,0,1,2,50.0,1,2,2,0,2,4,4,0
7523,4,1,1,3,0,3,7,42.9,4,10,3,7,3,7,17,0
7524,16,9,8,6,2,2,8,25.0,6,10,3,7,6,22,15,0
7525,25,15,13,11,1,15,26,57.7,11,38,15,23,32,57,151,1
7526,24,17,13,8,3,13,21,61.9,8,24,17,7,23,47,45,0
7527,1,0,1,0,0,1,2,50.0,1,2,0,2,0,1,2,0
7528,37,24,19,18,0,20,33,60.6,13,16,4,12,24,61,17,0
7529,6,4,3,2,1,1,3,33.3,2,4,0,4,1,7,1,0
7530,7,4,4,0,3,4,12,33.3,8,4,1,3,8,15,4,0
7531,36,25,8,17,11,20,47,42.6,27,35,2,33,19,55,19,0
7532,2,2,0,2,0,2,2,100.0,0,3,2,1,6,8,1,0
7533,46,23,12,25,9,26,57,45.6,31,28,2,26,10,56,10,1
7534,13,9,8,3,2,8,15,53.3,7,8,2,6,5,18,10,0
7535,57,36,30,21,6,27,56,48.2,29,26,7,19,37,94,28,0
7536,57,40,18,32,7,29,51,56.9,22,46,17,29,28,85,25,1
7537,6,3,2,3,1,3,9,33.3,6,4,0,4,0,6,9,0
7538,48,30,33,14,1,33,64,51.6,31,46,22,24,23,71,129,0
7539,8,5,0,4,4,5,8,62.5,3,6,1,5,0,8,2,0
7540,38,22,13,15,10,22,49,44.9,27,19,1,18,10,48,7,0
7541,0,0,0,0,0,0,3,0.0,3,0,0,0,0,0,12,2
7542,2,2,1,1,0,2,2,100.0,0,0,0,0,1,3,16,3
7543,0,0,0,0,0,0,0,0.0,0,0,0,0,0,0,5,1
7544,42,29,9,20,13,12,27,44.4,15,12,1,11,15,57,9,0
7545,4,3,0,3,1,0,3,0.0,3,2,0,2,0,4,9,0
7546,8,4,2,3,3,4,7,57.1,3,5,1,4,1,9,12,0
7547,6,5,2,3,1,1,14,7.1,13,4,0,4,3,9,4,0
7548,15,9,4,6,5,7,29,24.1,22,8,4,4,8,23,29,0
7549,59,38,38,16,5,36,79,45.6,43,47,17,30,36,95,80,0
7550,34,21,7,13,14,21,52,40.4,31,20,0,20,18,52,5,0
7551,0,0,0,0,0,0,1,0.0,1,0,0,0,1,1,2,2
7552,55,29,25,22,8,25,53,47.2,28,24,1,23,22,77,19,0
7553,34,22,17,16,1,12,25,48.0,13,19,3,16,7,41,10,0
7554,8,5,3,3,2,4,10,40.0,6,11,2,9,1,9,23,0
7555,6,3,1,2,3,2,8,25.0,6,11,5,6,1,7,17,0
7556,28,13,9,17,2,11,35,31.4,24,26,5,21,30,58,38,1
7557,42,29,32,7,3,26,39,66.7,13,26,10,16,25,67,51,7
7558,16,10,11,5,0,12,18,66.7,6,6,4,2,5,21,42,0
7559,0,0,0,0,0,0,0,0.0,0,1,0,1,0,0,0,0
7560,2,1,1,1,0,2,4,50.0,2,1,0,1,1,3,0,0
7561,3,1,0,1,2,0,5,0.0,5,8,3,5,2,5,7,0
7562,70,45,26,34,10,31,70,44.3,39,28,0,28,26,96,29,2
7563,0,0,0,0,0,0,1,0.0,1,0,0,0,0,0,2,0
7564,1,1,1,0,0,0,0,0.0,0,0,0,0,0,1,4,1
7565,1,0,0,1,0,1,2,50.0,1,0,0,0,2,3,5,0
7566,86,48,35,46,5,40,78,51.3,38,55,15,40,50,136,42,0
7567,80,49,54,22,4,47,76,61.8,29,36,13,23,32,112,105,2
7568,3,3,1,2,0,0,2,0.0,2,6,2,4,2,5,7,0
7569,64,43,16,27,21,29,62,46.8,33,32,3,29,20,84,32,0
7570,4,2,2,1,1,2,16,12.5,14,8,4,4,3,7,13,0
7571,15,10,8,5,2,11,20,55.0,9,15,6,9,15,30,42,0
7572,0,0,0,0,0,0,0,0.0,0,0,0,0,0,0,0,0
7573,0,0,0,0,0,0,0,0.0,0,0,0,0,0,0,0,0
7574,52,25,24,20,8,26,44,59.1,18,27,2,25,12,64,32,0
7575,65,44,42,18,5,30,57,52.6,27,40,8,32,49,114,59,1
7576,18,13,13,4,1,8,13,61.5,5,12,2,10,16,34,17,0
7577,1,0,1,0,0,1,1,100.0,0,0,0,0,1,2,0,0
7578,10,3,2,8,0,2,8,25.0,6,19,0,19,12,22,24,0
7579,24,15,16,7,1,9,17,52.9,8,33,28,5,25,49,185,0
7580,36,21,16,15,5,13,33,39.4,20,25,2,23,19,55,25,0
7581,48,29,16,22,10,21,46,45.7,25,24,3,21,9,57,14,0
7582,0,0,0,0,0,0,0,0.0,0,1,0,1,0,0,0,0
7583,0,0,0,0,0,0,0,0.0,0,0,0,0,0,0,0,0
7584,39,22,12,23,4,15,43,34.9,28,41,16,25,30,69,37,0
7585,0,0,0,0,0,0,0,0.0,0,0,0,0,0,0,1,0
7586,9,6,5,3,1,5,10,50.0,5,4,2,2,9,18,15,0
7587,8,4,3,5,0,3,5,60.0,2,4,0,4,1,9,4,0
7588,2,2,1,1,0,0,2,0.0,2,5,0,5,1,3,4,0
7589,19,13,6,7,6,7,14,50.0,7,15,3,12,12,31,15,0
7590,1,0,1,0,0,1,1,100.0,0,0,0,0,0,1,14,3
7591,11,6,3,7,1,4,8,50.0,4,14,1,13,19,30,19,0
7592,72,51,43,22,7,34,54,63.0,20,34,5,29,44,116,67,0
7593,0,0,0,0,0,0,1,0.0,1,0,0,0,0,0,2,1
7594,7,5,1,5,1,2,16,12.5,14,8,3,5,4,11,12,0
7595,27,16,12,15,0,17,24,70.8,7,20,6,14,17,44,25,0
7596,59,37,31,20,8,27,59,45.8,32,46,10,36,24,83,65,1
7597,30,19,14,10,6,17,23,73.9,6,31,6,25,17,47,36,1
7598,23,17,10,9,4,13,21,61.9,8,21,6,15,18,41,45,0
7599,1,0,1,0,0,1,5,20.0,4,6,0,6,9,10,8,0
7600,0,0,0,0,0,0,0,0.0,0,0,0,0,0,0,1,1
7601,1,1,1,0,0,0,2,0.0,2,0,0,0,0,1,6,0
7602,20,14,13,7,0,7,13,53.8,6,20,12,8,31,51,88,0
7603,63,40,27,24,12,35,58,60.3,23,23,5,18,30,93,42,2
7604,26,20,14,11,1,12,18,66.7,6,35,23,12,35,61,73,0
7605,42,26,18,23,1,16,30,53.3,14,25,6,19,21,63,41,0
7606,0,0,0,0,0,0,1,0.0,1,0,0,0,3,3,0,0
7607,28,22,15,11,2,10,33,30.3,23,17,1,16,12,40,5,0
7608,26,14,12,11,3,13,26,50.0,13,13,5,8,17,43,12,0
7609,53,36,36,14,3,25,44,56.8,19,39,23,16,52,105,102,1
7610,18,11,13,5,0,8,16,50.0,8,9,6,3,29,47,58,0
7611,41,20,19,20,2,12,23,52.2,11,19,5,14,29,70,25,1
7612,23,16,5,9,9,10,30,33.3,20,20,4,16,2,25,34,0
7613,1,1,1,0,0,0,0,0.0,0,0,0,0,0,1,0,0
7614,40,23,20,15,5,21,50,42.0,29,27,2,25,20,60,25,0
7615,96,50,41,48,7,48,82,58.5,34,50,10,40,44,140,47,0
7616,17,11,14,3,0,10,15,66.7,5,8,3,5,15,32,37,0
7617,71,40,42,27,2,33,55,60.0,22,62,35,27,57,128,159,0
7618,3,3,0,3,0,1,11,9.1,10,9,1,8,2,5,12,0
7619,13,6,11,2,0,7,14,50.0,7,6,2,4,14,27,20,1
7620,44,28,27,13,4,24,33,72.7,9,34,19,15,36,80,110,1
7621,39,26,16,17,6,18,33,54.5,15,32,5,27,14,53,22,0
7622,11,7,5,5,1,4,7,57.1,3,8,6,2,9,20,33,0
7623,3,2,0,2,1,2,2,100.0,0,7,1,6,2,5,6,0
7624,35,23,8,17,10,13,39,33.3,26,20,6,14,8,43,15,0
7625,38,20,9,23,6,18,32,56.3,14,21,5,16,33,71,17,0
7626,21,11,6,7,8,12,22,54.5,10,11,2,9,19,40,5,0
7627,30,20,11,11,8,15,27,55.6,12,20,4,16,10,40,12,0
7628,17,9,9,8,0,8,15,53.3,7,6,0,6,5,22,4,1
7629,4,4,3,1,0,2,6,33.3,4,6,2,4,8,12,21,1
7630,40,20,21,17,2,19,34,55.9,15,14,3,11,39,79,51,0
7631,19,11,12,7,0,7,13,53.8,6,21,17,4,21,40,113,0
7632,30,17,15,13,2,13,24,54.2,11,32,1,31,8,38,6,0
7633,19,14,11,6,2,14,22,63.6,8,12,4,8,11,30,25,0
7634,2,2,2,0,0,1,2,50.0,1,3,2,1,2,4,21,1
7635,7,4,4,3,0,2,3,66.7,1,4,3,1,8,15,20,2
7636,13,7,7,5,1,9,17,52.9,8,8,3,5,9,22,17,1
7637,6,4,4,2,0,3,14,21.4,11,4,2,2,3,9,12,0
7638,1,0,1,0,0,1,1,100.0,0,0,0,0,0,1,1,0
7639,0,0,0,0,0,0,1,0.0,1,0,0,0,1,1,5,1
7640,21,12,15,6,0,8,18,44.4,10,24,16,8,19,40,106,2
7641,7,5,3,2,2,6,12,50.0,6,7,1,6,3,10,5,0
7642,41,25,22,15,4,20,56,35.7,36,41,4,37,30,71,21,0
7643,8,4,3,3,2,3,12,25.0,9,12,2,10,2,10,5,0
7644,8,5,6,2,0,4,6,66.7,2,3,1,2,3,11,12,0
7645,14,10,8,4,2,4,8,50.0,4,13,3,10,13,27,34,0
7646,36,24,19,14,3,18,46,39.1,28,18,11,7,23,59,39,0
7647,1,1,1,0,0,1,1,100.0,0,0,0,0,1,2,0,0
7648,30,22,21,8,1,18,30,60.0,12,29,18,11,29,59,69,2
7649,69,41,47,21,1,41,68,60.3,27,48,23,25,59,128,147,1
7650,0,0,0,0,0,0,1,0.0,1,1,0,1,0,0,5,2
7651,7,2,0,5,2,2,5,40.0,3,8,0,8,1,8,6,0
7652,6,1,1,3,2,2,7,28.6,5,9,3,6,1,7,17,0
7653,1,1,0,1,0,0,0,0.0,0,1,0,1,0,1,0,0
7654,71,43,53,15,3,39,55,70.9,16,17,5,12,20,91,31,0
7655,6,4,4,1,1,3,7,42.9,4,5,2,3,1,7,3,0
7656,12,7,5,5,2,4,16,25.0,12,11,1,10,7,19,4,0
7657,31,17,20,9,2,14,26,53.8,12,28,18,10,34,65,95,0
7658,14,8,4,7,3,6,16,37.5,10,4,1,3,2,16,6,0
7659,21,11,5,11,5,10,22,45.5,12,13,2,11,3,24,2,0
7660,63,39,32,25,6,31,64,48.4,33,35,8,27,34,97,68,0
7661,2,0,2,0,0,1,2,50.0,1,2,1,1,1,3,0,0
7662,5,4,3,2,0,3,6,50.0,3,9,7,2,5,10,29,0
7663,54,38,19,30,5,22,56,39.3,34,22,6,16,31,85,25,0
7664,17,12,11,6,0,10,22,45.5,12,12,5,7,10,27,16,0
7665,9,8,7,2,0,7,8,87.5,1,3,2,1,5,14,14,1
7666,13,8,3,8,2,8,17,47.1,9,8,1,7,1,14,16,0
7667,23,15,12,8,3,8,30,26.7,22,18,0,18,10,33,11,0
7668,36,23,14,12,10,13,24,54.2,11,27,3,24,4,40,18,0
7669,80,50,53,23,4,30,46,65.2,16,62,33,29,72,152,123,0
7670,4,4,1,2,1,4,8,50.0,4,1,0,1,1,5,7,0
7671,1,1,1,0,0,0,1,0.0,1,1,0,1,0,1,5,0
7672,20,13,16,3,1,14,18,77.8,4,17,7,10,17,37,73,0
7673,7,3,3,4,0,2,6,33.3,4,2,1,1,8,15,3,0
7674,44,32,20,22,2,18,43,41.9,25,27,10,17,28,72,37,0
7675,3,1,1,2,0,1,3,33.3,2,8,1,7,1,4,8,0
7676,24,17,13,9,2,13,28,46.4,15,11,1,10,5,29,1,0
7677,16,10,0,9,7,10,33,30.3,23,15,0,15,6,22,5,0
7678,19,12,10,7,2,5,19,26.3,14,9,0,9,10,29,22,0
7679,10,8,7,3,0,4,5,80.0,1,4,2,2,11,21,27,1
7680,12,8,3,7,2,5,11,45.5,6,19,7,12,2,14,42,0
7681,9,5,0,6,3,2,6,33.3,4,13,3,10,1,10,20,0
7682,11,7,4,5,2,7,19,36.8,12,10,2,8,22,33,26,1
7683,26,20,13,11,2,12,25,48.0,13,12,4,8,18,44,18,1
7684,37,25,16,15,6,24,39,61.5,15,37,9,28,25,62,60,1
7685,19,11,8,6,5,10,26,38.5,16,14,2,12,3,22,16,0
7686,37,19,18,18,1,22,46,47.8,24,46,30,16,36,73,101,0
7687,6,5,4,2,0,3,11,27.3,8,7,2,5,4,10,6,0
7688,76,48,42,28,6,42,63,66.7,21,43,12,31,32,108,86,1
7689,1,1,1,0,0,0,0,0.0,0,0,0,0,0,1,2,0
7690,4,3,3,1,0,2,4,50.0,2,0,0,0,0,4,1,0
7691,73,46,30,34,9,46,90,51.1,44,34,13,21,37,110,22,4
7692,6,4,4,2,0,5,11,45.5,6,4,1,3,4,10,4,0
7693,46,26,31,15,0,23,38,60.5,15,40,15,25,59,105,115,1
7694,16,11,10,6,0,11,15,73.3,4,14,6,8,15,31,26,0
7695,65,34,21,33,11,27,47,57.4,20,48,9,39,32,97,50,0
7696,36,22,17,19,0,15,22,68.2,7,22,10,12,30,66,81,0
7697,49,31,30,18,1,24,44,54.5,20,51,28,23,38,87,102,2
7698,2,0,0,1,1,1,3,33.3,2,6,0,6,4,6,4,0
7699,36,18,10,20,6,23,54,42.6,31,33,5,28,9,45,8,0
7700,0,0,0,0,0,0,0,0.0,0,0,0,0,0,0,1,0
7701,16,9,4,11,1,11,21,52.4,10,16,2,14,12,28,30,1
7702,19,10,6,11,2,8,15,53.3,7,6,1,5,7,26,7,0
7703,0,0,0,0,0,0,1,0.0,1,0,0,0,1,1,0,0
7704,4,2,2,1,1,1,2,50.0,1,1,0,1,3,7,5,0
7705,40,24,32,6,2,22,36,61.1,14,26,9,17,22,62,47,0
7706,50,32,16,29,5,26,62,41.9,36,25,4,21,16,66,42,0
7707,0,0,0,0,0,0,0,0.0,0,1,0,1,1,1,0,0
7708,15,13,9,6,0,6,7,85.7,1,19,12,7,5,20,26,0
7709,15,10,1,11,3,1,10,10.0,9,5,0,5,7,22,10,0
7710,7,7,6,1,0,6,9,66.7,3,3,0,3,7,14,12,0
7711,52,33,27,19,6,31,55,56.4,24,39,11,28,25,77,39,1
7712,4,4,3,0,1,3,5,60.0,2,2,0,2,1,5,3,0
7713,26,15,11,12,3,12,27,44.4,15,11,1,10,6,32,10,0
7714,57,36,16,31,10,28,67,41.8,39,37,7,30,37,94,31,1
7715,26,11,8,15,3,12,25,48.0,13,8,1,7,12,38,9,0
7716,16,9,2,12,2,3,7,42.9,4,17,5,12,2,18,16,0
7717,78,46,19,52,7,40,85,47.1,45,57,6,51,34,112,20,0
7718,0,0,0,0,0,0,0,0.0,0,1,1,0,0,0,0,0
7719,13,9,7,4,2,8,11,72.7,3,7,3,4,9,22,24,0
7720,5,4,4,1,0,4,5,80.0,1,1,0,1,2,7,5,0
7721,26,17,20,5,1,7,13,53.8,6,12,4,8,25,51,48,1
7722,0,0,0,0,0,0,2,0.0,2,1,0,1,0,0,10,0
7723,12,9,9,3,0,9,11,81.8,2,8,6,2,7,19,24,0
7724,38,25,28,9,1,22,38,57.9,16,40,30,10,50,88,130,0
7725,12,6,6,5,1,8,13,61.5,5,12,0,12,0,12,4,0
7726,3,0,3,0,0,2,3,66.7,1,2,0,2,1,4,7,0
7727,35,28,17,14,4,20,53,37.7,33,29,0,29,16,51,4,0
7728,0,0,0,0,0,0,1,0.0,1,1,0,1,0,0,0,0
7729,16,11,5,9,2,8,28,28.6,20,16,1,15,10,26,12,0
7730,52,35,35,13,4,37,71,52.1,34,43,7,36,27,79,78,0
7731,4,2,2,0,2,2,3,66.7,1,0,0,0,1,5,2,0
7732,1,0,0,1,0,0,2,0.0,2,2,0,2,0,1,3,0
7733,2,1,1,1,0,1,2,50.0,1,1,0,1,1,3,3,0
7734,28,17,11,11,6,7,14,50.0,7,26,7,19,3,31,21,0
7735,6,6,0,4,2,2,12,16.7,10,8,0,8,0,6,2,0
7736,33,21,10,15,8,15,41,36.6,26,30,0,30,8,41,1,0
7737,55,37,20,26,9,20,52,38.5,32,48,12,36,19,74,16,0
7738,0,0,0,0,0,0,0,0.0,0,0,0,0,0,0,0,0
7739,8,5,6,1,1,6,11,54.5,5,16,10,6,16,24,44,0
7740,1,0,0,1,0,1,2,50.0,1,0,0,0,0,1,0,0
7741,2,1,0,1,1,1,1,100.0,0,1,0,1,2,4,9,0
7742,82,52,59,18,5,32,55,58.2,23,37,11,26,46,128,76,1
7743,10,3,3,5,2,2,8,25.0,6,4,0,4,2,12,1,0
7744,4,2,2,2,0,0,1,0.0,1,2,0,2,1,5,0,0
7745,5,4,4,0,1,3,4,75.0,1,1,0,1,1,6,3,1
7746,18,9,10,7,1,12,19,63.2,7,11,4,7,9,27,16,1
7747,12,2,8,4,0,4,10,40.0,6,5,0,5,9,21,4,0
7748,0,0,0,0,0,0,0,0.0,0,0,0,0,1,1,1,0
7749,34,20,21,11,2,12,23,52.2,11,20,8,12,10,44,42,0
7750,0,0,0,0,0,0,1,0.0,1,2,1,1,0,0,1,0
7751,13,8,8,2,3,2,3,66.7,1,3,0,3,6,19,11,0
7752,19,12,4,10,5,8,15,53.3,7,16,2,14,7,26,24,0
7753,0,0,0,0,0,0,1,0.0,1,0,0,0,1,1,0,0
7754,0,0,0,0,0,0,0,0.0,0,0,0,0,1,1,0,0
7755,3,2,2,1,0,0,3,0.0,3,6,4,2,4,7,15,0
7756,4,4,4,0,0,1,2,50.0,1,1,1,0,1,5,1,0
7757,5,2,1,3,1,3,5,60.0,2,5,1,4,1,6,3,0
7758,0,0,0,0,0,0,1,0.0,1,1,1,0,0,0,2,0
7759,6,4,2,2,2,2,2,100.0,0,3,0,3,3,9,0,0
7760,3,2,0,2,1,0,0,0.0,0,1,0,1,0,3,0,0
7761,16,9,5,9,2,8,18,44.4,10,12,1,11,12,28,14,0
7762,19,10,7,8,4,10,17,58.8,7,12,3,9,9,28,19,0
7763,23,16,12,8,3,10,27,37.0,17,11,3,8,12,35,28,0
7764,63,35,42,14,7,34,46,73.9,12,29,8,21,19,82,57,2
7765,1,0,0,1,0,0,1,0.0,1,1,0,1,0,1,1,0
7766,52,27,29,22,1,38,94,40.4,56,42,10,32,17,69,53,0
7767,54,35,44,8,2,34,52,65.4,18,14,7,7,12,66,95,0
7768,21,15,15,5,1,12,16,75.0,4,22,12,10,35,56,79,2
7769,14,8,5,4,5,5,17,29.4,12,18,4,14,5,19,28,0
7770,16,12,7,5,4,8,12,66.7,4,9,0,9,4,20,10,0
7771,7,1,1,5,1,3,3,100.0,0,11,1,10,0,7,11,0
7772,1,0,1,0,0,1,1,100.0,0,1,0,1,0,1,0,0
7773,36,16,20,14,2,17,27,63.0,10,30,2,28,19,55,29,0
7774,2,1,1,1,0,1,1,100.0,0,4,3,1,1,3,1,0
7775,10,5,7,2,1,6,11,54.5,5,12,4,8,6,16,19,0
7776,21,10,2,13,6,9,34,26.5,25,26,3,23,16,37,19,1
7777,15,11,8,6,1,8,17,47.1,9,9,0,9,11,26,17,0
7778,12,8,10,2,0,9,11,81.8,2,8,2,6,6,18,15,0
7779,44,20,18,25,1,19,47,40.4,28,32,8,24,36,80,36,0
7780,3,0,1,1,1,0,4,0.0,4,7,1,6,2,5,9,0
7781,1,0,1,0,0,1,1,100.0,0,1,0,1,0,1,10,2
7782,50,24,16,27,7,22,70,31.4,48,25,0,25,15,65,5,1
7783,47,24,18,23,6,12,31,38.7,19,16,4,12,27,74,14,0
7784,2,1,1,1,0,2,4,50.0,2,0,0,0,1,3,0,0
7785,44,27,23,14,7,18,50,36.0,32,42,1,41,20,64,7,1
7786,5,3,2,2,1,3,4,75.0,1,0,0,0,5,10,4,0
7787,28,15,13,12,3,10,14,71.4,4,10,1,9,9,37,9,0
7788,60,34,24,23,13,30,75,40.0,45,31,8,23,36,96,33,0
7789,6,3,2,4,0,2,7,28.6,5,5,2,3,1,7,15,0
7790,1,1,0,0,1,0,2,0.0,2,0,0,0,0,1,1,0
7791,1,1,1,0,0,1,2,50.0,1,0,0,0,0,1,28,2
7792,0,0,0,0,0,0,1,0.0,1,1,0,1,1,1,6,0
7793,3,2,0,2,1,1,5,20.0,4,5,0,5,0,3,11,0
7794,11,8,1,6,4,4,14,28.6,10,13,3,10,2,13,14,0
7795,62,47,27,24,11,33,66,50.0,33,64,5,59,17,79,58,0
7796,23,11,11,9,3,7,19,36.8,12,23,1,22,18,41,11,0
7797,22,17,8,11,3,6,25,24.0,19,17,3,14,10,32,11,0
7798,14,11,1,9,4,7,25,28.0,18,12,1,11,5,19,4,0
7799,46,27,21,22,3,27,65,41.5,38,29,4,25,10,56,8,1
7800,16,13,12,4,0,8,10,80.0,2,14,11,3,12,28,68,0
7801,19,14,8,6,5,9,22,40.9,13,15,3,12,7,26,9,0
7802,1,1,1,0,0,0,0,0.0,0,2,1,1,1,2,0,0
7803,26,17,15,8,3,10,18,55.6,8,19,13,6,25,51,20,0
7804,13,8,6,5,2,7,22,31.8,15,14,0,14,12,25,8,0
7805,64,38,31,19,14,24,57,42.1,33,25,2,23,17,81,20,2
7806,2,2,0,2,0,0,5,0.0,5,1,0,1,1,3,1,0
7807,11,5,2,6,3,4,14,28.6,10,12,2,10,5,16,11,0
7808,4,3,1,2,1,3,9,33.3,6,5,0,5,1,5,2,0
7809,11,6,4,4,3,4,11,36.4,7,7,1,6,7,18,5,0
7810,2,2,1,0,1,0,2,0.0,2,2,1,1,1,3,2,0
7811,1,1,0,1,0,0,1,0.0,1,0,0,0,0,1,0,0
7812,1,0,0,1,0,0,0,0.0,0,0,0,0,0,1,0,0
7813,39,26,25,12,2,21,33,63.6,12,24,11,13,13,52,69,0
7814,5,3,3,1,1,1,7,14.3,6,3,0,3,0,5,2,0
7815,6,5,2,3,1,2,10,20.0,8,9,1,8,2,8,4,0
7816,40,27,19,18,3,12,26,46.2,14,32,5,27,16,56,17,0
7817,63,43,41,19,3,30,51,58.8,21,18,6,12,40,103,69,2
7818,1,0,1,0,0,1,3,33.3,2,1,1,0,0,1,4,0
7819,0,0,0,0,0,0,0,0.0,0,0,0,0,0,0,0,0
7820,3,2,0,3,0,2,5,40.0,3,2,0,2,0,3,2,0
7821,6,3,3,3,0,1,4,25.0,3,1,0,1,5,11,3,0
7822,23,18,13,7,3,11,16,68.8,5,12,8,4,29,52,36,0
7823,5,4,2,2,1,2,8,25.0,6,11,1,10,3,8,4,0
7824,26,16,14,9,3,10,13,76.9,3,28,22,6,28,54,62,1
7825,0,0,0,0,0,0,1,0.0,1,1,0,1,0,0,0,0
7826,16,9,9,6,1,11,15,73.3,4,15,8,7,18,34,48,4
7827,27,19,11,12,4,12,24,50.0,12,16,3,13,18,45,3,1
7828,9,5,4,4,1,8,14,57.1,6,2,1,1,2,11,9,0
7829,7,5,5,2,0,4,7,57.1,3,7,6,1,7,14,15,0
7830,1,1,0,1,0,0,1,0.0,1,3,0,3,1,2,4,0
7831,0,0,0,0,0,0,0,0.0,0,0,0,0,0,0,4,1
7832,13,9,6,7,0,4,12,33.3,8,10,6,4,10,23,37,0
7833,22,13,3,9,10,7,15,46.7,8,12,1,11,2,24,21,0
7834,8,3,3,4,1,1,9,11.1,8,9,2,7,7,15,44,0
7835,64,37,33,27,4,30,70,42.9,40,46,11,35,53,117,45,0
7836,6,2,2,3,1,1,6,16.7,5,3,0,3,1,7,1,0
7837,4,3,2,1,1,4,6,66.7,2,0,0,0,1,5,4,1
7838,32,17,17,10,5,14,36,38.9,22,32,3,29,17,49,19,0
7839,10,4,2,4,4,4,6,66.7,2,7,0,7,5,15,5,0
7840,63,42,43,16,4,47,90,52.2,43,32,14,18,29,92,110,0
7841,1,0,1,0,0,0,1,0.0,1,0,0,0,1,2,3,0
7842,20,11,9,6,5,7,31,22.6,24,17,1,16,5,25,7,0
7843,22,13,6,9,7,9,36,25.0,27,28,2,26,10,32,10,0
7844,33,17,21,10,2,20,32,62.5,12,15,4,11,30,63,69,0
7845,31,17,15,15,1,17,46,37.0,29,25,8,17,21,52,31,0
7846,33,20,20,12,1,18,41,43.9,23,16,4,12,14,47,27,1
7847,0,0,0,0,0,0,0,0.0,0,0,0,0,0,0,0,0
7848,17,8,13,3,1,11,16,68.8,5,20,13,7,18,35,81,2
7849,14,9,3,9,2,5,12,41.7,7,9,1,8,8,22,8,0
7850,51,29,17,28,6,16,45,35.6,29,34,4,30,12,63,7,0
7851,12,6,5,7,0,6,13,46.2,7,6,1,5,5,17,7,0
7852,19,14,7,11,1,8,14,57.1,6,11,4,7,10,29,15,0
7853,3,3,1,1,1,3,3,100.0,0,0,0,0,0,3,1,0
7854,73,48,26,31,16,35,110,31.8,75,53,3,50,40,113,7,2
7855,0,0,0,0,0,0,0,0.0,0,0,0,0,0,0,6,0
7856,7,4,1,3,3,3,9,33.3,6,6,0,6,2,9,2,0
7857,0,0,0,0,0,0,1,0.0,1,0,0,0,0,0,5,0
7858,60,45,26,24,10,24,62,38.7,38,31,1,30,20,80,11,1
7859,36,21,23,10,3,15,38,39.5,23,29,14,15,37,73,10,0
7860,41,23,27,13,1,21,40,52.5,19,40,20,20,46,87,125,0
7861,1,1,0,1,0,1,1,100.0,0,0,0,0,0,1,1,0
7862,6,4,1,3,2,3,6,50.0,3,1,0,1,5,11,1,0
7863,0,0,0,0,0,0,0,0.0,0,0,0,0,1,1,2,0
7864,37,22,26,10,1,20,28,71.4,8,25,17,8,23,60,128,0
7865,28,13,17,9,2,20,44,45.5,24,11,1,10,13,41,14,0
7866,9,6,4,3,2,4,9,44.4,5,3,0,3,2,11,2,0
7867,2,1,1,0,1,1,1,100.0,0,0,0,0,1,3,0,0
7868,63,41,27,27,9,28,57,49.1,29,48,7,41,29,92,31,0
7869,0,0,0,0,0,0,0,0.0,0,0,0,0,0,0,1,1
7870,3,3,2,1,0,1,5,20.0,4,4,0,4,3,6,2,0
7871,99,75,53,36,10,46,80,57.5,34,47,21,26,54,153,115,2
7872,24,14,11,10,3,15,22,68.2,7,31,15,16,19,43,30,2
7873,25,14,7,13,5,12,27,44.4,15,13,2,11,19,44,9,1
7874,19,10,10,9,0,8,19,42.1,11,26,11,15,15,34,70,0
7875,0,0,0,0,0,0,0,0.0,0,0,0,0,0,0,0,0
7876,2,1,1,0,1,1,3,33.3,2,0,0,0,2,4,2,0
7877,34,23,6,20,8,14,35,40.0,21,27,9,18,18,52,58,1
7878,32,22,29,3,0,21,35,60.0,14,53,31,22,31,63,142,0
7879,40,23,13,18,9,18,46,39.1,28,21,4,17,32,72,29,0
7880,3,2,2,0,1,1,2,50.0,1,2,0,2,0,3,0,0
7881,0,0,0,0,0,0,0,0.0,0,0,0,0,0,0,2,0
7882,76,53,40,33,3,37,59,62.7,22,55,36,19,44,120,198,1
7883,13,7,11,1,1,11,17,64.7,6,8,4,4,2,15,18,0
7884,0,0,0,0,0,0,0,0.0,0,0,0,0,0,0,0,0
7885,9,5,2,3,4,5,22,22.7,17,21,0,21,16,25,6,0
7886,57,38,23,18,16,25,81,30.9,56,41,5,36,18,75,48,0
7887,3,2,0,1,2,2,4,50.0,2,4,0,4,3,6,2,0
7888,17,8,3,10,4,3,15,20.0,12,15,2,13,2,19,18,0
7889,16,8,9,6,1,10,14,71.4,4,12,5,7,11,27,15,0
7890,71,40,31,37,3,26,39,66.7,13,25,4,21,18,89,44,0
7891,0,0,0,0,0,0,2,0.0,2,2,0,2,0,0,0,0
7892,45,27,27,12,6,18,30,60.0,12,14,4,10,22,67,30,1
7893,7,5,1,2,4,4,7,57.1,3,1,0,1,3,10,5,0
7894,78,48,31,30,17,32,79,40.5,47,43,2,41,21,99,24,0
7895,1,0,1,0,0,0,2,0.0,2,2,1,1,2,3,7,0
7896,5,5,1,3,1,3,5,60.0,2,6,1,5,3,8,2,0
7897,0,0,0,0,0,0,0,0.0,0,1,0,1,0,0,1,0
7898,56,31,29,25,2,29,45,64.4,16,19,1,18,15,71,43,0
7899,29,15,19,9,1,12,24,50.0,12,13,1,12,6,35,12,0
7900,14,5,6,6,2,8,18,44.4,10,10,0,10,2,16,4,0
7901,0,0,0,0,0,0,1,0.0,1,0,0,0,0,0,0,0
7902,1,1,0,0,1,0,0,0.0,0,1,0,1,1,2,0,0
7903,51,26,31,14,6,26,44,59.1,18,17,5,12,13,64,24,0
7904,52,29,21,21,10,23,57,40.4,34,19,4,15,14,66,18,1
7905,32,17,17,12,3,14,29,48.3,15,22,12,10,28,60,27,0
7906,0,0,0,0,0,0,0,0.0,0,4,4,0,1,1,1,1
7907,33,23,27,6,0,22,30,73.3,8,21,12,9,35,68,82,0
7908,36,19,25,10,1,14,15,93.3,1,32,19,13,44,80,169,3
7909,37,26,19,15,3,26,42,61.9,16,13,1,12,12,49,33,0
7910,52,34,32,15,5,32,58,55.2,26,11,5,6,16,68,36,0
7911,8,5,3,4,1,2,5,40.0,3,3,1,2,4,12,4,0
7912,38,22,18,11,9,15,38,39.5,23,17,2,15,15,53,31,0
7913,1,1,1,0,0,0,2,0.0,2,2,0,2,1,2,1,0
7914,7,4,4,1,2,3,15,20.0,12,5,0,5,6,13,10,1
7915,0,0,0,0,0,0,3,0.0,3,2,0,2,0,0,12,1
7916,32,21,17,9,6,20,28,71.4,8,27,12,15,31,63,60,0
7917,65,41,45,18,2,30,42,71.4,12,30,15,15,32,97,135,1
7918,34,18,21,11,2,13,30,43.3,17,54,38,16,58,92,197,1
7919,67,40,32,29,6,35,79,44.3,44,27,8,19,34,101,53,0
7920,19,10,4,10,5,9,13,69.2,4,9,4,5,7,26,3,1
7921,45,23,21,22,2,31,41,75.6,10,41,19,22,25,70,28,0
7922,40,22,24,12,4,20,56,35.7,36,29,4,25,38,78,64,2
7923,48,27,28,15,5,23,48,47.9,25,44,26,18,46,94,90,1
7924,5,4,3,1,1,3,5,60.0,2,0,0,0,4,9,17,0
7925,1,1,0,1,0,1,2,50.0,1,1,1,0,0,1,4,0
7926,0,0,0,0,0,0,0,0.0,0,0,0,0,0,0,0,1
7927,25,16,13,9,3,9,26,34.6,17,19,9,10,22,47,27,0
7928,13,10,10,3,0,7,13,53.8,6,21,12,9,22,35,58,0
7929,72,46,41,24,7,43,71,60.6,28,35,8,27,19,91,59,1
7930,26,17,4,14,8,11,30,36.7,19,25,7,18,15,41,38,0
7931,0,0,0,0,0,0,0,0.0,0,1,0,1,1,1,1,0
7932,0,0,0,0,0,0,2,0.0,2,0,0,0,0,0,9,1
7933,19,11,10,7,2,13,19,68.4,6,8,2,6,7,26,24,0
7934,33,21,19,12,2,17,23,73.9,6,17,8,9,29,62,63,0
7935,71,42,28,37,6,32,52,61.5,20,34,15,19,44,115,84,0
7936,0,0,0,0,0,0,2,0.0,2,2,1,1,2,2,1,0
7937,19,11,10,9,0,14,21,66.7,7,11,4,7,15,34,31,0
7938,0,0,0,0,0,0,0,0.0,0,0,0,0,0,0,2,0
7939,59,36,28,28,3,25,48,52.1,23,38,10,28,26,85,29,0
7940,1,0,0,1,0,0,0,0.0,0,1,1,0,1,2,2,0
7941,0,0,0,0,0,0,0,0.0,0,0,0,0,0,0,0,0
7942,15,7,9,4,2,6,22,27.3,16,6,1,5,14,29,7,1
7943,2,1,0,2,0,1,1,100.0,0,0,0,0,0,2,1,0
7944,8,7,8,0,0,4,7,57.1,3,11,8,3,9,17,19,2
7945,15,9,7,6,2,9,19,47.4,10,17,4,13,10,25,14,0
7946,2,2,2,0,0,1,1,100.0,0,1,1,0,0,2,5,0
7947,61,40,11,31,19,33,66,50.0,33,45,5,40,24,85,23,0
7948,16,11,6,6,4,8,13,61.5,5,7,1,6,4,20,12,1
7949,7,3,0,3,4,2,8,25.0,6,10,1,9,2,9,13,1
7950,44,23,26,15,3,23,45,51.1,22,37,15,22,18,62,78,1
7951,104,76,64,32,8,71,100,71.0,29,43,9,34,64,168,99,0
7952,37,24,15,18,4,10,48,20.8,38,23,2,21,15,52,4,0
7953,34,18,19,14,1,16,29,55.2,13,46,34,12,61,95,145,0
7954,0,0,0,0,0,0,0,0.0,0,1,0,1,1,1,0,0
7955,51,36,37,10,4,24,39,61.5,15,45,24,21,37,88,140,0
7956,61,33,32,25,4,29,42,69.0,13,48,12,36,29,90,73,2
7957,3,3,1,1,1,1,5,20.0,4,20,2,18,5,8,42,0
7958,18,8,6,8,4,8,18,44.4,10,8,2,6,2,20,12,0
7959,0,0,0,0,0,0,0,0.0,0,0,0,0,0,0,1,0
7960,15,11,8,7,0,7,15,46.7,8,8,5,3,7,22,26,1
7961,0,0,0,0,0,0,0,0.0,0,2,1,1,0,0,0,0
7962,2,1,2,0,0,2,13,15.4,11,2,0,2,3,5,5,0
7963,71,43,27,36,8,31,47,66.0,16,25,10,15,15,86,37,1
7964,26,11,15,11,0,11,21,52.4,10,17,8,9,17,43,32,0
7965,14,10,5,7,2,2,16,12.5,14,19,2,17,14,28,28,0
7966,12,9,8,3,1,4,17,23.5,13,10,0,10,5,17,7,0
7967,20,14,12,6,2,12,19,63.2,7,35,16,19,18,38,97,1
7968,22,12,8,11,3,13,27,48.1,14,15,1,14,10,32,10,0
7969,46,32,28,11,7,26,40,65.0,14,24,10,14,18,64,66,0
7970,6,3,5,1,0,4,10,40.0,6,1,0,1,3,9,7,0
7971,1,0,1,0,0,1,3,33.3,2,0,0,0,0,1,5,2
7972,24,17,11,9,4,12,37,32.4,25,31,1,30,11,35,21,0
7973,53,32,32,19,2,27,43,62.8,16,53,36,17,42,95,143,1
7974,24,15,12,11,1,9,13,69.2,4,15,11,4,8,32,46,1
7975,7,7,6,1,0,4,5,80.0,1,2,0,2,4,11,21,0
7976,42,22,24,18,0,17,32,53.1,15,23,5,18,21,63,50,0
7977,5,2,4,1,0,2,2,100.0,0,4,0,4,2,7,4,0
7978,22,14,16,6,0,9,12,75.0,3,32,20,12,25,47,69,0
7979,44,25,18,17,9,18,69,26.1,51,29,1,28,14,58,15,1
7980,42,20,22,17,3,21,42,50.0,21,35,2,33,19,61,31,0
7981,7,3,2,4,1,2,7,28.6,5,6,2,4,2,9,4,0
7982,1,1,1,0,0,0,0,0.0,0,1,0,1,0,1,0,0
7983,12,8,4,7,1,6,14,42.9,8,8,3,5,9,21,13,0
7984,2,1,0,2,0,1,2,50.0,1,1,0,1,0,2,0,0
7985,9,4,5,2,2,3,11,27.3,8,9,0,9,4,13,1,0
7986,60,43,16,31,13,17,59,28.8,42,24,2,22,41,101,45,0
7987,7,4,3,3,1,4,14,28.6,10,7,0,7,3,10,4,0
7988,37,26,16,19,2,22,49,44.9,27,35,7,28,37,74,56,0
7989,37,24,16,20,1,16,39,41.0,23,16,2,14,11,48,22,0
7990,50,30,31,16,3,27,66,40.9,39,19,5,14,16,66,63,1
7991,59,39,18,34,7,29,60,48.3,31,35,12,23,25,84,27,2
7992,33,18,12,17,4,18,30,60.0,12,19,7,12,21,54,67,1
7993,6,5,0,4,2,3,4,75.0,1,12,0,12,4,10,2,0
7994,13,9,7,5,1,9,22,40.9,13,9,4,5,9,22,11,1
7995,0,0,0,0,0,0,2,0.0,2,1,0,1,1,1,2,0
7996,42,27,15,21,6,16,58,27.6,42,29,4,25,22,64,26,0
7997,14,7,5,4,5,7,11,63.6,4,4,0,4,2,16,13,0
7998,0,0,0,0,0,0,0,0.0,0,0,0,0,0,0,1,0
7999,30,17,13,10,7,18,33,54.5,15,21,6,15,11,41,27,0
8000,51,26,22,25,4,23,42,54.8,19,19,6,13,14,65,31,0
8001,5,2,3,2,0,3,7,42.9,4,9,6,3,9,14,10,0
8002,0,0,0,0,0,0,0,0.0,0,0,0,0,0,0,0,0
8003,1,1,0,1,0,1,1,100.0,0,0,0,0,0,1,0,0
8004,53,35,34,17,2,34,71,47.9,37,30,5,25,34,87,45,0
8005,7,3,2,3,2,2,4,50.0,2,5,0,5,1,8,3,0
8006,1,1,0,0,1,0,0,0.0,0,0,0,0,1,2,1,0
8007,56,33,40,15,1,26,44,59.1,18,56,48,8,33,89,164,1
8008,6,2,3,2,1,3,8,37.5,5,2,0,2,1,7,3,0
8009,2,0,2,0,0,1,8,12.5,7,3,0,3,2,4,6,0
8010,58,36,29,26,3,27,59,45.8,32,31,13,18,17,75,42,1
8011,1,0,0,1,0,0,0,0.0,0,1,0,1,0,1,0,0
8012,2,1,0,1,1,1,3,33.3,2,1,0,1,4,6,2,0
8013,3,2,0,1,2,3,3,100.0,0,0,0,0,0,3,1,0
8014,23,15,6,14,3,8,18,44.4,10,17,2,15,7,30,14,0
8015,58,32,22,26,10,28,78,35.9,50,40,2,38,18,76,28,0
8016,32,19,16,15,1,16,32,50.0,16,18,12,6,17,49,33,0
8017,3,2,1,2,0,1,3,33.3,2,2,0,2,0,3,1,0
8018,41,24,26,13,2,17,32,53.1,15,22,3,19,13,54,43,2
8019,52,31,17,29,6,18,44,40.9,26,45,21,24,58,110,40,2
8020,44,27,25,12,7,21,30,70.0,9,39,20,19,23,67,89,0
8021,41,29,7,17,17,17,51,33.3,34,40,2,38,6,47,12,0
8022,0,0,0,0,0,0,0,0.0,0,0,0,0,0,0,0,0
8023,30,19,14,11,5,11,23,47.8,12,23,4,19,15,45,35,0
8024,14,9,4,6,4,5,11,45.5,6,15,2,13,9,23,12,0
8025,1,0,1,0,0,0,1,0.0,1,0,0,0,1,2,0,0
8026,10,5,2,8,0,5,16,31.3,11,11,4,7,7,17,11,0
8027,7,4,3,3,1,4,7,57.1,3,3,0,3,3,10,6,0
8028,2,1,1,1,0,2,2,100.0,0,0,0,0,0,2,0,0
8029,24,17,10,14,0,10,21,47.6,11,18,11,7,8,32,31,0
8030,0,0,0,0,0,0,1,0.0,1,0,0,0,1,1,12,3
8031,25,12,21,3,1,15,19,78.9,4,9,7,2,7,32,34,3
8032,16,9,3,7,6,6,20,30.0,14,19,0,19,9,25,6,0
8033,32,16,9,15,8,11,29,37.9,18,31,0,31,14,46,10,1
8034,37,22,21,13,3,23,46,50.0,23,14,4,10,11,48,10,0
8035,40,21,21,18,1,26,47,55.3,21,44,23,21,43,83,141,1
8036,50,32,16,27,7,31,64,48.4,33,41,17,24,29,79,31,3
8037,40,27,23,15,2,21,50,42.0,29,27,7,20,18,58,49,0
8038,4,4,0,3,1,2,4,50.0,2,1,0,1,1,5,2,0
8039,15,12,6,4,5,9,18,50.0,9,7,1,6,8,23,10,0
8040,27,17,8,16,3,15,27,55.6,12,21,7,14,21,48,17,0
8041,0,0,0,0,0,0,0,0.0,0,1,0,1,0,0,0,0
8042,16,11,10,4,2,6,13,46.2,7,23,18,5,13,29,99,0
8043,33,24,7,15,11,12,46,26.1,34,28,1,27,5,38,18,0
8044,6,5,3,3,0,5,7,71.4,2,4,2,2,3,9,7,0
8045,35,21,12,17,6,21,46,45.7,25,18,3,15,14,49,19,2
8046,18,16,7,7,4,7,23,30.4,16,6,0,6,4,22,4,0
8047,4,2,2,1,1,2,6,33.3,4,2,1,1,7,11,4,0
8048,62,39,23,31,8,30,51,58.8,21,40,9,31,25,87,39,1
8049,32,17,18,10,4,15,25,60.0,10,16,9,7,15,47,22,1
8050,4,2,1,0,3,2,3,66.7,1,2,0,2,7,11,3,0
8051,8,5,3,4,1,2,7,28.6,5,8,4,4,9,17,12,0
8052,3,2,1,1,1,2,3,66.7,1,2,0,2,1,4,2,0
8053,1,1,0,1,0,0,0,0.0,0,2,0,2,1,2,1,0
8054,22,14,10,8,4,10,17,58.8,7,12,3,9,12,34,16,0
8055,16,9,3,9,4,6,25,24.0,19,10,3,7,14,30,13,0
8056,23,17,13,8,2,5,13,38.5,8,16,0,16,13,36,13,1
8057,0,0,0,0,0,0,1,0.0,1,0,0,0,0,0,1,0
8058,14,10,3,10,1,6,14,42.9,8,13,1,12,3,17,10,0
8059,19,13,8,6,5,5,14,35.7,9,6,0,6,5,24,2,0
8060,0,0,0,0,0,0,1,0.0,1,1,0,1,1,1,8,2
8061,13,10,3,6,4,4,13,30.8,9,22,3,19,3,16,9,0
8062,0,0,0,0,0,0,0,0.0,0,0,0,0,0,0,9,1
8063,67,40,31,30,6,27,57,47.4,30,26,6,20,24,91,22,0
8064,65,39,30,28,7,39,57,68.4,18,26,11,15,42,107,64,1
8065,6,3,5,1,0,5,9,55.6,4,0,0,0,0,6,13,0
8066,18,8,4,11,3,7,17,41.2,10,6,0,6,2,20,1,1
8067,4,4,1,3,0,1,1,100.0,0,2,0,2,0,4,1,0
8068,1,1,0,1,0,0,0,0.0,0,2,1,1,0,1,0,0
8069,3,2,2,1,0,3,7,42.9,4,3,1,2,1,4,2,0
8070,69,42,32,35,2,37,89,41.6,52,57,12,45,64,133,77,1
8071,38,21,16,15,7,16,32,50.0,16,29,3,26,11,49,18,1
8072,10,6,3,4,3,3,8,37.5,5,8,0,8,8,18,4,0
8073,37,21,12,23,2,18,37,48.6,19,17,1,16,17,54,17,1
8074,29,15,19,10,0,17,31,54.8,14,20,8,12,19,48,59,0
8075,2,2,0,2,0,0,1,0.0,1,2,1,1,0,2,0,0
8076,30,14,13,10,7,11,30,36.7,19,6,0,6,14,44,16,0
8077,40,20,19,17,4,19,36,52.8,17,23,3,20,16,56,26,0
8078,34,21,21,11,2,18,31,58.1,13,10,3,7,16,50,23,0
8079,13,9,7,5,1,7,18,38.9,11,15,0,15,1,14,4,0
8080,8,4,0,5,3,4,7,57.1,3,7,0,7,2,10,1,1
8081,12,7,3,9,0,3,5,60.0,2,4,2,2,5,17,12,0
8082,48,30,36,9,3,18,28,64.3,10,32,17,15,27,75,84,1
8083,3,1,2,0,1,1,2,50.0,1,2,0,2,1,4,8,0
8084,30,22,15,10,5,14,28,50.0,14,12,5,7,15,45,28,0
8085,0,0,0,0,0,0,6,0.0,6,0,0,0,0,0,12,5
8086,0,0,0,0,0,0,0,0.0,0,0,0,0,0,0,17,1
8087,1,1,0,1,0,1,1,100.0,0,0,0,0,0,1,0,0
8088,25,15,12,11,2,13,23,56.5,10,7,1,6,2,27,7,0
8089,11,8,3,6,2,4,9,44.4,5,1,0,1,7,18,5,0
8090,12,7,4,8,0,5,11,45.5,6,10,5,5,6,18,13,0
8091,15,10,8,7,0,5,17,29.4,12,9,3,6,13,28,16,0
8092,0,0,0,0,0,0,0,0.0,0,0,0,0,0,0,0,0
8093,8,5,7,1,0,3,7,42.9,4,1,0,1,6,14,4,0
8094,43,27,20,22,1,18,32,56.3,14,25,9,16,30,73,19,1
8095,8,6,7,1,0,3,5,60.0,2,10,2,8,6,14,27,0
8096,15,9,6,5,4,7,9,77.8,2,11,1,10,5,20,5,0
8097,14,9,4,10,0,5,17,29.4,12,10,0,10,6,20,7,0
8098,48,26,31,14,3,20,27,74.1,7,19,10,9,23,71,121,0
8099,0,0,0,0,0,0,0,0.0,0,0,0,0,1,1,0,1
8100,0,0,0,0,0,0,0,0.0,0,0,0,0,0,0,2,0
8101,6,3,5,1,0,1,3,33.3,2,3,1,2,4,10,0,0
8102,30,14,11,12,7,16,35,45.7,19,20,3,17,20,50,54,0
8103,44,25,28,13,3,15,25,60.0,10,23,8,15,29,73,65,0
8104,12,9,8,4,0,9,12,75.0,3,20,14,6,12,24,29,0
8105,0,0,0,0,0,0,0,0.0,0,0,0,0,0,0,0,0
8106,1,0,1,0,0,1,1,100.0,0,0,0,0,0,1,6,1
8107,4,3,0,3,1,2,6,33.3,4,2,0,2,2,6,1,0
8108,1,0,0,1,0,1,4,25.0,3,2,0,2,2,3,2,0
8109,0,0,0,0,0,0,0,0.0,0,0,0,0,0,0,1,0
8110,27,18,8,11,8,12,37,32.4,25,26,1,25,7,34,11,0
8111,4,4,1,1,2,1,2,50.0,1,3,0,3,2,6,0,0
8112,60,38,23,29,8,24,47,51.1,23,55,14,41,32,92,58,2
8113,107,82,56,45,6,49,89,55.1,40,53,7,46,53,160,33,0
8114,13,8,3,7,3,8,15,53.3,7,5,1,4,15,28,9,0
8115,48,31,13,21,14,18,30,60.0,12,24,2,22,9,57,8,0
8116,0,0,0,0,0,0,0,0.0,0,0,0,0,0,0,2,0
8117,45,31,21,20,4,27,50,54.0,23,25,6,19,27,72,30,1
8118,13,5,6,5,2,3,7,42.9,4,3,1,2,4,17,7,0
8119,52,36,24,23,5,29,62,46.8,33,41,8,33,37,89,74,0
8120,2,1,1,0,1,1,2,50.0,1,2,0,2,1,3,2,0
8121,1,1,0,1,0,0,0,0.0,0,0,0,0,1,2,3,0
8122,56,37,20,32,4,22,43,51.2,21,26,6,20,21,77,29,1
8123,30,19,16,13,1,14,36,38.9,22,22,8,14,22,52,22,0
8124,48,34,35,12,1,21,31,67.7,10,48,36,12,50,98,198,0
8125,6,4,1,5,0,0,6,0.0,6,6,2,4,6,12,5,2
8126,0,0,0,0,0,0,0,0.0,0,0,0,0,0,0,0,0
8127,67,35,25,39,3,37,75,49.3,38,47,15,32,28,95,48,0
8128,0,0,0,0,0,0,1,0.0,1,0,0,0,0,0,3,1
8129,2,1,2,0,0,0,0,0.0,0,0,0,0,1,3,1,0
8130,26,13,16,6,4,12,16,75.0,4,13,1,12,8,34,9,0
8131,11,6,2,7,2,4,9,44.4,5,16,4,12,3,14,27,0
8132,32,19,18,12,2,20,34,58.8,14,52,33,19,31,63,87,0
8133,0,0,0,0,0,0,0,0.0,0,0,0,0,0,0,0,0
8134,0,0,0,0,0,0,1,0.0,1,1,0,1,0,0,0,0
8135,0,0,0,0,0,0,0,0.0,0,0,0,0,0,0,0,0
8136,25,21,20,4,1,19,39,48.7,20,21,13,8,33,58,74,0
8137,20,14,10,5,5,7,22,31.8,15,17,0,17,7,27,23,0
8138,15,7,3,9,3,7,19,36.8,12,24,3,21,8,23,10,0
8139,21,15,13,7,1,10,27,37.0,17,10,3,7,25,46,49,0
8140,10,5,5,2,3,6,13,46.2,7,13,0,13,5,15,9,0
8141,12,7,7,4,1,8,11,72.7,3,7,3,4,3,15,15,0
8142,0,0,0,0,0,0,0,0.0,0,0,0,0,0,0,9,3
8143,17,9,8,6,3,9,19,47.4,10,6,0,6,10,27,3,0
8144,13,8,1,12,0,7,14,50.0,7,14,3,11,7,20,4,0
8145,32,21,14,14,4,19,31,61.3,12,23,5,18,30,62,33,1
8146,1,0,0,0,1,1,2,50.0,1,0,0,0,0,1,0,0
8147,10,5,3,4,3,2,8,25.0,6,6,0,6,4,14,15,0
8148,2,2,0,1,1,1,1,100.0,0,1,0,1,1,3,0,0
8149,2,2,2,0,0,1,1,100.0,0,0,0,0,1,3,7,2
8150,31,20,15,13,3,18,39,46.2,21,18,2,16,16,47,43,1
8151,1,0,1,0,0,1,1,100.0,0,0,0,0,0,1,3,0
8152,0,0,0,0,0,0,2,0.0,2,0,0,0,1,1,16,3
8153,23,14,10,12,1,7,28,25.0,21,15,2,13,10,33,11,1
8154,54,34,34,16,4,35,53,66.0,18,26,4,22,26,80,44,0
8155,1,1,0,1,0,0,2,0.0,2,8,2,6,0,1,5,0
8156,17,9,8,6,3,10,20,50.0,10,11,3,8,7,24,17,1
8157,16,8,7,6,3,7,17,41.2,10,21,1,20,18,34,18,0
8158,1,0,1,0,0,1,1,100.0,0,0,0,0,1,2,20,1
8159,3,1,1,1,1,1,3,33.3,2,0,0,0,1,4,0,0
8160,0,0,0,0,0,0,0,0.0,0,0,0,0,0,0,27,1
8161,16,10,7,8,1,10,17,58.8,7,9,1,8,4,20,4,1
8162,30,18,4,17,9,6,16,37.5,10,21,6,15,7,37,24,0
8163,2,1,1,1,0,1,3,33.3,2,3,2,1,2,4,5,0
8164,40,24,18,14,8,21,42,50.0,21,27,6,21,22,62,45,1
8165,46,26,35,9,2,25,46,54.3,21,51,34,17,47,93,161,1
8166,11,6,6,2,3,4,11,36.4,7,6,1,5,4,15,20,0
8167,0,0,0,0,0,0,1,0.0,1,0,0,0,0,0,6,0
8168,17,12,7,8,2,8,28,28.6,20,25,3,22,19,36,16,0
8169,45,23,14,22,9,14,31,45.2,17,23,3,20,14,59,17,1
8170,20,13,7,8,5,6,22,27.3,16,22,0,22,9,29,15,0
8171,29,16,23,5,1,17,29,58.6,12,12,8,4,10,39,46,0
8172,66,35,25,35,6,36,70,51.4,34,47,11,36,32,98,45,1
8173,11,6,8,3,0,9,21,42.9,12,16,2,14,3,14,13,0
8174,1,1,1,0,0,0,0,0.0,0,1,0,1,0,1,19,2
8175,2,2,1,0,1,1,2,50.0,1,1,0,1,1,3,1,0
8176,0,0,0,0,0,0,0,0.0,0,1,0,1,2,2,17,5
8177,30,20,25,5,0,19,22,86.4,3,20,11,9,27,57,71,0
8178,24,13,15,8,1,12,23,52.2,11,21,5,16,23,47,49,1
8179,12,8,8,4,0,10,15,66.7,5,11,3,8,7,19,5,0
8180,49,33,31,15,3,32,56,57.1,24,36,12,24,35,84,74,0
8181,2,1,1,1,0,1,6,16.7,5,2,1,1,2,4,5,0
8182,10,6,5,5,0,5,10,50.0,5,5,2,3,13,23,10,0
8183,83,51,28,46,9,38,67,56.7,29,46,20,26,45,128,61,1
8184,13,9,4,9,0,5,11,45.5,6,3,0,3,2,15,5,0
8185,0,0,0,0,0,0,0,0.0,0,0,0,0,0,0,7,1
8186,4,3,0,2,2,2,2,100.0,0,3,0,3,2,6,5,0
8187,10,7,2,7,1,4,11,36.4,7,4,2,2,4,14,3,0
8188,8,6,5,3,0,5,10,50.0,5,28,17,11,20,28,92,1
8189,22,16,9,8,5,9,18,50.0,9,10,0,10,16,38,11,0
8190,26,14,10,13,3,15,35,42.9,20,19,2,17,4,30,4,0
8191,1,1,1,0,0,1,2,50.0,1,0,0,0,3,4,3,0
8192,3,1,1,1,1,0,1,0.0,1,1,0,1,2,5,1,0
8193,13,10,7,5,1,4,6,66.7,2,3,0,3,6,19,8,0
8194,10,4,3,7,0,3,9,33.3,6,3,0,3,1,11,9,0
8195,49,31,20,24,5,30,41,73.2,11,18,4,14,11,60,38,0
8196,4,1,4,0,0,4,6,66.7,2,0,0,0,1,5,12,1
8197,1,1,1,0,0,0,0,0.0,0,0,0,0,0,1,1,0
8198,23,14,13,10,0,10,16,62.5,6,9,6,3,22,45,15,0
8199,57,39,24,32,1,25,63,39.7,38,27,6,21,44,101,23,3
8200,24,12,12,9,3,12,29,41.4,17,8,0,8,3,27,9,1
8201,8,5,1,3,4,6,13,46.2,7,4,0,4,0,8,2,0
8202,66,42,27,32,7,35,55,63.6,20,47,13,34,36,102,73,0
8203,53,33,20,32,1,26,53,49.1,27,30,10,20,34,87,51,2
8204,0,0,0,0,0,0,0,0.0,0,0,0,0,0,0,0,0
8205,12,4,7,5,0,7,16,43.8,9,6,2,4,4,16,8,0
8206,16,7,5,9,2,9,19,47.4,10,6,0,6,3,19,8,0
8207,0,0,0,0,0,0,0,0.0,0,0,0,0,0,0,0,0
8208,17,13,4,11,2,5,13,38.5,8,13,0,13,7,24,4,0
8209,1,1,1,0,0,0,0,0.0,0,0,0,0,0,1,2,0
8210,0,0,0,0,0,0,0,0.0,0,0,0,0,0,0,0,0
8211,53,28,16,32,5,21,44,47.7,23,46,21,25,24,77,52,1
8212,6,1,0,6,0,2,7,28.6,5,13,4,9,2,8,27,1
8213,52,32,22,24,6,18,45,40.0,27,39,3,36,28,80,27,1
8214,55,34,36,16,3,40,65,61.5,25,30,15,15,58,113,99,0
8215,12,9,5,6,1,4,8,50.0,4,13,2,11,3,15,11,0
8216,1,0,0,0,1,0,1,0.0,1,0,0,0,0,1,0,0
8217,29,18,23,5,1,14,20,70.0,6,23,10,13,17,46,74,0
8218,37,23,15,19,3,18,44,40.9,26,12,4,8,17,54,9,0
8219,20,18,12,8,0,8,15,53.3,7,14,11,3,16,36,59,4
8220,49,31,25,19,5,25,43,58.1,18,47,16,31,81,130,129,1
8221,7,6,2,5,0,3,5,60.0,2,1,0,1,2,9,3,0
8222,59,37,27,27,5,30,47,63.8,17,20,8,12,21,80,43,0
8223,9,5,5,4,0,4,7,57.1,3,2,0,2,1,10,9,0
8224,56,37,24,13,19,24,55,43.6,31,18,0,18,10,66,3,0
8225,1,1,1,0,0,1,1,100.0,0,0,0,0,0,1,8,0
8226,9,4,6,1,2,7,18,38.9,11,14,3,11,8,17,10,0
8227,5,3,2,1,2,3,10,30.0,7,7,2,5,4,9,25,0
8228,24,17,18,6,0,12,21,57.1,9,14,5,9,14,38,29,0
8229,23,11,10,12,1,13,20,65.0,7,35,20,15,30,53,90,0
8230,32,15,17,13,2,16,29,55.2,13,13,5,8,11,43,27,0
8231,16,11,5,11,0,10,18,55.6,8,12,2,10,18,34,50,0
8232,10,6,7,3,0,5,6,83.3,1,7,6,1,1,11,17,0
8233,2,1,1,1,0,1,3,33.3,2,2,0,2,0,2,0,0
8234,0,0,0,0,0,0,0,0.0,0,0,0,0,0,0,0,0
8235,10,6,3,6,1,3,9,33.3,6,7,0,7,4,14,6,0
8236,30,22,21,5,4,16,27,59.3,11,20,4,16,11,41,41,0
8237,43,26,21,18,4,20,37,54.1,17,25,6,19,23,66,40,0
8238,1,1,0,0,1,0,5,0.0,5,4,0,4,0,1,2,0
8239,0,0,0,0,0,0,0,0.0,0,0,0,0,0,0,0,0
8240,21,12,17,3,1,7,15,46.7,8,35,28,7,38,59,182,1
8241,41,24,23,15,3,18,33,54.5,15,19,8,11,19,60,32,0
8242,3,1,1,0,2,0,3,0.0,3,0,0,0,1,4,0,0
8243,50,34,37,13,0,21,34,61.8,13,32,22,10,30,80,185,0
8244,8,4,4,3,1,5,8,62.5,3,1,0,1,4,12,13,0
8245,1,1,1,0,0,0,0,0.0,0,2,0,2,0,1,0,0
8246,0,0,0,0,0,0,1,0.0,1,0,0,0,0,0,2,0
8247,21,13,10,8,3,11,19,57.9,8,13,6,7,19,40,30,0
8248,58,33,30,23,5,38,61,62.3,23,22,5,17,27,85,22,0
8249,20,13,15,5,0,11,21,52.4,10,28,21,7,31,51,102,0
8250,94,64,60,25,9,44,70,62.9,26,41,11,30,61,155,97,0
8251,5,3,2,0,3,3,8,37.5,5,5,1,4,1,6,12,0
8252,35,26,24,11,0,15,26,57.7,11,21,11,10,25,60,73,0
8253,37,20,13,21,3,15,33,45.5,18,17,3,14,21,58,22,0
8254,15,10,4,10,1,5,11,45.5,6,3,0,3,1,16,3,0
8255,10,9,1,4,5,4,6,66.7,2,6,1,5,4,14,2,0
8256,6,2,3,2,1,4,5,80.0,1,6,1,5,1,7,3,0
8257,2,0,0,2,0,2,3,66.7,1,2,0,2,1,3,1,0
8258,42,27,16,24,2,13,29,44.8,16,18,5,13,19,61,17,1
8259,0,0,0,0,0,0,1,0.0,1,0,0,0,1,1,0,0
8260,5,3,4,1,0,3,5,60.0,2,4,0,4,4,9,6,0
8261,32,22,10,18,4,14,27,51.9,13,19,2,17,12,44,14,1
8262,8,6,3,5,0,4,4,100.0,0,9,8,1,11,19,15,0
8263,35,24,19,12,4,15,33,45.5,18,32,2,30,16,51,10,0
8264,6,2,0,5,1,3,7,42.9,4,4,0,4,1,7,8,0
8265,99,60,46,44,9,43,89,48.3,46,59,14,45,44,143,58,2
8266,1,0,1,0,0,0,0,0.0,0,0,0,0,1,2,1,0
8267,53,31,26,24,3,33,58,56.9,25,22,8,14,23,76,48,0
8268,26,18,11,7,8,10,23,43.5,13,21,2,19,8,34,12,0
8269,59,39,21,28,10,16,31,51.6,15,31,8,23,29,88,33,0
8270,1,1,0,1,0,0,0,0.0,0,0,0,0,1,2,1,0
8271,17,11,9,8,0,4,15,26.7,11,10,1,9,14,31,22,0
8272,10,5,3,4,3,3,9,33.3,6,16,3,13,5,15,11,0
8273,61,34,29,26,6,36,56,64.3,20,42,9,33,46,107,77,1
8274,0,0,0,0,0,0,0,0.0,0,0,0,0,1,1,3,0
8275,10,6,7,1,2,5,11,45.5,6,2,1,1,6,16,10,0
8276,19,10,6,6,7,10,26,38.5,16,19,0,19,8,27,9,0
8277,41,28,12,21,8,21,38,55.3,17,15,2,13,16,57,14,0
8278,1,0,0,1,0,0,0,0.0,0,0,0,0,1,2,0,0
8279,2,2,1,1,0,1,1,100.0,0,0,0,0,0,2,0,0
8280,1,1,0,0,1,1,1,100.0,0,1,0,1,0,1,0,0
8281,1,0,0,0,1,1,2,50.0,1,4,0,4,3,4,3,0
8282,4,1,3,0,1,1,3,33.3,2,4,2,2,6,10,27,0
8283,2,1,0,2,0,1,1,100.0,0,0,0,0,0,2,0,0
8284,1,1,0,1,0,1,2,50.0,1,1,1,0,1,2,1,0
8285,23,17,16,5,2,10,12,83.3,2,13,6,7,18,41,48,0
8286,30,21,17,6,7,14,27,51.9,13,20,1,19,9,39,8,1
8287,14,5,6,8,0,7,22,31.8,15,6,0,6,9,23,8,1
8288,39,24,10,25,4,13,43,30.2,30,23,1,22,18,57,19,0
8289,0,0,0,0,0,0,0,0.0,0,1,0,1,1,1,0,0
8290,3,3,0,2,1,0,1,0.0,1,8,2,6,2,5,2,0
8291,27,13,14,11,2,13,26,50.0,13,6,3,3,10,37,35,0
8292,35,20,18,10,7,20,41,48.8,21,10,3,7,21,56,38,0
8293,52,30,30,19,3,31,56,55.4,25,26,10,16,33,85,18,1
8294,1,1,1,0,0,1,1,100.0,0,0,0,0,0,1,11,1
8295,26,22,16,6,4,17,29,58.6,12,12,2,10,14,40,34,0
8296,45,28,13,30,2,19,49,38.8,30,23,7,16,34,79,36,2
8297,6,3,0,3,3,2,7,28.6,5,4,2,2,1,7,3,0
8298,21,14,11,9,1,16,18,88.9,2,15,5,10,8,29,22,0
8299,9,8,5,4,0,5,5,100.0,0,9,4,5,5,14,17,0
8300,27,22,9,11,7,11,38,28.9,27,15,2,13,11,38,11,0
8301,0,0,0,0,0,0,1,0.0,1,0,0,0,0,0,0,3
8302,25,15,11,10,4,15,39,38.5,24,25,0,25,20,45,33,1
8303,26,16,14,11,1,15,28,53.6,13,10,3,7,9,35,30,0
8304,0,0,0,0,0,0,0,0.0,0,0,0,0,0,0,0,0
8305,4,1,2,2,0,0,1,0.0,1,1,0,1,0,4,0,0
8306,69,46,41,24,4,45,63,71.4,18,33,16,17,54,123,150,0
8307,2,2,1,0,1,0,2,0.0,2,0,0,0,2,4,10,0
8308,32,17,26,6,0,18,29,62.1,11,14,8,6,27,59,92,0
8309,0,0,0,0,0,0,2,0.0,2,1,0,1,0,0,1,0
8310,70,39,24,36,10,32,54,59.3,22,46,10,36,40,110,27,2
8311,45,30,20,25,0,23,44,52.3,21,21,8,13,19,64,21,1
8312,15,6,8,5,2,6,19,31.6,13,18,5,13,16,31,21,0
8313,8,3,6,2,0,0,2,0.0,2,6,2,4,4,12,1,0
8314,3,2,0,2,1,1,2,50.0,1,1,0,1,0,3,0,0
8315,17,12,15,2,0,6,11,54.5,5,19,15,4,16,33,120,0
8316,34,18,22,10,2,20,31,64.5,11,23,7,16,16,50,39,1
8317,25,19,12,8,5,9,17,52.9,8,7,1,6,16,41,37,0
8318,29,19,18,9,2,18,29,62.1,11,22,11,11,26,55,69,4
8319,18,12,13,4,1,9,13,69.2,4,14,8,6,16,34,66,0
8320,0,0,0,0,0,0,0,0.0,0,0,0,0,0,0,0,0
8321,2,2,1,1,0,1,2,50.0,1,0,0,0,0,2,0,0
8322,23,14,5,13,5,8,14,57.1,6,9,3,6,7,30,2,0
8323,1,1,1,0,0,0,0,0.0,0,0,0,0,0,1,11,1
8324,15,10,8,5,2,9,11,81.8,2,14,5,9,3,18,23,1
8325,5,1,1,1,3,2,6,33.3,4,2,0,2,2,7,3,0
8326,11,8,1,7,3,3,8,37.5,5,3,0,3,2,13,8,0
8327,56,41,35,15,6,35,64,54.7,29,29,8,21,30,86,102,0
8328,0,0,0,0,0,0,0,0.0,0,0,0,0,0,0,0,0
8329,0,0,0,0,0,0,0,0.0,0,0,0,0,0,0,2,0
8330,7,4,1,5,1,1,2,50.0,1,1,0,1,0,7,1,0
8331,0,0,0,0,0,0,2,0.0,2,0,0,0,0,0,0,0
8332,2,0,2,0,0,0,0,0.0,0,2,0,2,2,4,3,0
8333,70,39,35,29,6,49,103,47.6,54,30,7,23,48,118,47,0
8334,66,41,32,26,8,22,54,40.7,32,42,18,24,35,101,86,1
8335,26,19,1,18,7,7,23,30.4,16,17,3,14,6,32,8,0
8336,3,2,1,2,0,1,3,33.3,2,1,0,1,4,7,3,0
8337,11,10,9,2,0,6,7,85.7,1,4,2,2,15,26,57,2
8338,14,10,1,11,2,9,17,52.9,8,6,1,5,3,17,17,0
8339,28,17,18,8,2,19,31,61.3,12,29,19,10,41,69,109,2
8340,5,2,2,1,2,2,3,66.7,1,5,0,5,0,5,0,0
8341,17,14,0,13,4,4,8,50.0,4,17,0,17,4,21,5,0
8342,14,6,3,7,4,6,14,42.9,8,9,1,8,7,21,5,0
8343,0,0,0,0,0,0,0,0.0,0,0,0,0,0,0,0,0
8344,15,6,3,10,2,5,15,33.3,10,11,4,7,2,17,3,1
8345,10,6,8,1,1,6,16,37.5,10,4,0,4,5,15,5,0
8346,9,5,3,5,1,5,7,71.4,2,6,2,4,6,15,4,0
8347,38,27,20,9,9,14,39,35.9,25,17,1,16,18,56,35,0
8348,14,11,12,2,0,11,25,44.0,14,7,0,7,9,23,10,0
8349,29,22,5,20,4,10,29,34.5,19,11,2,9,7,36,6,0
8350,25,17,18,7,0,17,29,58.6,12,15,8,7,22,47,59,1
8351,7,4,5,2,0,5,11,45.5,6,7,3,4,15,22,51,2
8352,29,18,12,12,5,13,36,36.1,23,29,5,24,14,43,46,0
8353,4,1,1,2,1,4,5,80.0,1,2,0,2,0,4,1,0
8354,2,1,2,0,0,1,2,50.0,1,2,1,1,2,4,4,0
8355,2,2,0,1,1,2,10,20.0,8,3,2,1,1,3,2,0
8356,10,6,5,5,0,4,10,40.0,6,11,9,2,12,22,24,0
8357,33,14,20,13,0,16,25,64.0,9,24,17,7,37,70,98,0
8358,0,0,0,0,0,0,0,0.0,0,0,0,0,0,0,0,0
8359,29,17,18,10,1,18,41,43.9,23,22,7,15,20,49,46,1
8360,20,16,6,12,2,7,26,26.9,19,14,4,10,6,26,7,0
8361,7,4,2,4,1,1,7,14.3,6,13,3,10,4,11,6,0
8362,0,0,0,0,0,0,0,0.0,0,0,0,0,0,0,0,0
8363,1,1,1,0,0,1,1,100.0,0,0,0,0,0,1,3,0
8364,78,53,51,22,5,47,76,61.8,29,38,10,28,39,117,82,2
8365,0,0,0,0,0,0,0,0.0,0,0,0,0,0,0,0,0
8366,0,0,0,0,0,0,1,0.0,1,0,0,0,0,0,14,0
8367,31,20,9,18,4,13,25,52.0,12,16,1,15,10,41,8,0
8368,7,4,2,3,2,1,8,12.5,7,8,0,8,5,12,9,0
8369,59,37,38,17,4,33,56,58.9,23,8,1,7,39,98,69,1
8370,24,16,11,10,3,11,25,44.0,14,29,0,29,9,33,6,0
8371,34,24,15,13,6,18,29,62.1,11,14,2,12,10,44,15,0
8372,18,6,0,9,9,5,15,33.3,10,10,1,9,2,20,13,0
8373,64,37,39,22,3,34,51,66.7,17,33,17,16,36,100,121,0
8374,21,16,12,9,0,9,25,36.0,16,6,2,4,11,32,6,0
8375,29,23,14,6,9,10,26,38.5,16,20,2,18,10,39,21,1
8376,67,52,45,20,2,43,81,53.1,38,40,10,30,55,122,82,3
8377,5,3,0,1,4,1,3,33.3,2,4,0,4,1,6,2,0
8378,1,0,1,0,0,1,1,100.0,0,0,0,0,2,3,8,0
8379,2,0,1,1,0,2,4,50.0,2,1,0,1,0,2,1,0
8380,29,17,5,21,3,11,26,42.3,15,13,1,12,16,45,14,0
8381,17,11,5,8,4,11,20,55.0,9,9,1,8,6,23,8,0
8382,23,10,8,13,2,15,33,45.5,18,15,3,12,14,37,12,0
8383,0,0,0,0,0,0,0,0.0,0,0,0,0,0,0,0,0
8384,1,0,0,1,0,1,1,100.0,0,0,0,0,0,1,0,0
8385,3,3,3,0,0,3,4,75.0,1,3,0,3,0,3,12,2
8386,50,26,23,19,8,20,42,47.6,22,26,6,20,30,80,44,0
8387,47,26,23,19,5,22,63,34.9,41,26,5,21,23,70,51,0
8388,33,22,27,4,2,17,23,73.9,6,35,26,9,29,62,106,2
8389,0,0,0,0,0,0,0,0.0,0,0,0,0,0,0,3,0
8390,33,17,16,15,2,23,45,51.1,22,27,6,21,18,51,34,1
8391,9,3,4,3,2,7,11,63.6,4,5,0,5,5,14,0,0
8392,3,3,0,3,0,2,6,33.3,4,1,0,1,2,5,4,0
8393,75,46,36,32,7,41,76,53.9,35,28,7,21,41,116,30,1
8394,2,2,1,1,0,1,2,50.0,1,2,0,2,1,3,2,0
8395,61,31,31,23,7,30,52,57.7,22,31,6,25,20,81,39,0
8396,20,14,14,6,0,15,27,55.6,12,18,14,4,20,40,94,1
8397,33,19,21,10,2,19,26,73.1,7,43,34,9,27,60,118,1
8398,0,0,0,0,0,0,0,0.0,0,0,0,0,0,0,2,0
8399,0,0,0,0,0,0,0,0.0,0,0,0,0,2,2,35,2
8400,25,17,17,7,1,14,30,46.7,16,26,15,11,32,57,90,1
8401,6,3,1,4,1,2,3,66.7,1,3,1,2,4,10,3,0
8402,27,18,17,9,1,19,38,50.0,19,20,5,15,19,46,29,0
8403,34,14,5,21,8,7,32,21.9,25,31,4,27,12,46,19,0
8404,30,18,9,19,2,19,42,45.2,23,20,4,16,19,49,20,0
8405,32,22,11,16,5,15,29,51.7,14,11,3,8,18,50,42,0
8406,7,5,2,5,0,6,12,50.0,6,10,0,10,2,9,0,0
8407,11,9,4,2,5,4,8,50.0,4,18,4,14,9,20,9,0
8408,0,0,0,0,0,0,0,0.0,0,0,0,0,0,0,0,0
8409,66,42,26,29,11,30,64,46.9,34,50,8,42,28,94,47,0
8410,30,16,16,13,1,18,30,60.0,12,21,8,13,22,52,52,0
8411,59,41,25,23,11,41,58,70.7,17,25,5,20,25,84,40,0
8412,3,2,0,1,2,2,4,50.0,2,2,0,2,3,6,0,0
8413,24,14,9,9,6,9,27,33.3,18,13,0,13,7,31,2,0
8414,35,19,19,13,3,17,32,53.1,15,31,13,18,22,57,24,0
8415,15,15,6,8,1,8,18,44.4,10,4,1,3,7,22,7,0
8416,2,2,1,1,0,2,2,100.0,0,0,0,0,0,2,0,0
8417,18,12,12,5,1,7,10,70.0,3,11,1,10,13,31,6,0
8418,39,25,25,13,1,22,35,62.9,13,37,26,11,50,89,120,1
8419,11,8,7,4,0,7,12,58.3,5,9,4,5,20,31,36,2
8420,0,0,0,0,0,0,0,0.0,0,1,0,1,0,0,1,0
8421,10,9,5,5,0,7,11,63.6,4,2,1,1,4,14,5,0
8422,17,10,5,7,5,12,29,41.4,17,12,0,12,7,24,11,0
8423,9,8,6,2,1,5,10,50.0,5,3,1,2,3,12,8,0
8424,10,5,4,5,1,7,13,53.8,6,7,0,7,1,11,5,0
8425,10,4,4,6,0,5,12,41.7,7,7,1,6,6,16,1,1
8426,23,10,9,12,2,10,42,23.8,32,18,0,18,13,36,7,0
8427,10,7,1,9,0,5,10,50.0,5,3,0,3,8,18,10,0
8428,15,9,10,5,0,7,13,53.8,6,2,0,2,4,19,1,0
8429,7,1,1,6,0,2,5,40.0,3,7,4,3,12,19,9,0
8430,22,15,17,4,1,15,24,62.5,9,36,24,12,18,40,120,0
8431,35,18,12,13,10,17,51,33.3,34,24,8,16,30,65,25,0
8432,24,18,11,11,2,10,28,35.7,18,17,1,16,9,33,13,0
8433,95,68,69,21,5,50,80,62.5,30,37,12,25,54,149,103,0
8434,6,4,1,2,3,3,5,60.0,2,5,1,4,1,7,4,0
8435,49,29,22,21,6,23,53,43.4,30,38,12,26,34,83,48,1
8436,19,11,3,11,5,9,15,60.0,6,10,1,9,0,19,9,0
8437,5,3,2,3,0,3,5,60.0,2,2,0,2,2,7,5,0
8438,16,11,8,8,0,8,18,44.4,10,4,1,3,2,18,3,0
8439,0,0,0,0,0,0,1,0.0,1,0,0,0,0,0,0,0
8440,3,1,1,2,0,1,7,14.3,6,9,2,7,0,3,4,0
8441,6,3,1,4,1,3,5,60.0,2,10,3,7,3,9,15,0
8442,0,0,0,0,0,0,0,0.0,0,0,0,0,0,0,0,0
8443,33,20,14,16,3,15,30,50.0,15,32,13,19,18,51,38,2
8444,49,32,23,21,5,23,51,45.1,28,33,2,31,13,62,12,0
8445,60,39,31,23,6,36,63,57.1,27,47,17,30,46,106,30,0
8446,8,3,5,3,0,3,5,60.0,2,10,7,3,7,15,61,0
8447,29,15,20,7,2,14,26,53.8,12,25,14,11,29,58,45,0
8448,13,10,9,4,0,6,13,46.2,7,13,8,5,12,25,37,0
8449,22,13,8,10,4,9,13,69.2,4,20,9,11,20,42,28,0
8450,4,0,0,4,0,2,4,50.0,2,4,0,4,0,4,2,0
8451,13,8,3,6,4,5,13,38.5,8,6,1,5,7,20,27,0
8452,29,22,21,8,0,23,34,67.6,11,17,10,7,25,54,58,2
8453,3,2,1,1,1,2,5,40.0,3,5,3,2,6,9,12,0
8454,12,10,10,2,0,6,12,50.0,6,6,0,6,6,18,1,1
8455,38,25,12,23,3,20,53,37.7,33,23,1,22,8,46,15,0
8456,10,2,0,8,2,1,7,14.3,6,10,0,10,2,12,2,0
8457,35,21,19,11,5,14,33,42.4,19,31,1,30,5,40,14,1
8458,13,9,4,8,1,4,13,30.8,9,11,2,9,3,16,6,0
8459,10,7,1,5,4,5,10,50.0,5,7,1,6,5,15,8,0
8460,0,0,0,0,0,0,0,0.0,0,0,0,0,0,0,0,0
8461,1,0,1,0,0,1,1,100.0,0,1,0,1,1,2,3,0
8462,23,17,10,11,2,12,22,54.5,10,9,1,8,15,38,23,0
8463,0,0,0,0,0,0,0,0.0,0,0,0,0,0,0,0,0
8464,0,0,0,0,0,0,2,0.0,2,1,0,1,0,0,7,0
8465,24,15,10,11,3,9,25,36.0,16,27,1,26,32,56,26,0
8466,9,5,2,5,2,0,4,0.0,4,11,3,8,8,17,20,0
8467,5,4,1,3,1,1,1,100.0,0,9,3,6,7,12,5,0
8468,21,10,9,11,1,12,18,66.7,6,26,10,16,28,49,97,0
8469,0,0,0,0,0,0,1,0.0,1,0,0,0,0,0,1,0
8470,16,10,1,8,7,9,28,32.1,19,25,3,22,6,22,14,0
8471,24,13,12,6,6,10,23,43.5,13,9,3,6,6,30,17,1
8472,40,25,6,24,10,14,38,36.8,24,31,1,30,8,48,15,0
8473,18,12,7,7,4,7,16,43.8,9,14,3,11,15,33,26,0
8474,16,7,4,7,5,5,19,26.3,14,13,0,13,8,24,9,0
8475,0,0,0,0,0,0,0,0.0,0,0,0,0,0,0,0,0
8476,0,0,0,0,0,0,0,0.0,0,0,0,0,0,0,0,0
8477,10,7,4,5,1,8,8,100.0,0,2,0,2,6,16,6,0
8478,51,27,22,25,4,24,48,50.0,24,33,10,23,22,73,42,0
8479,0,0,0,0,0,0,0,0.0,0,0,0,0,0,0,0,0
8480,32,24,12,16,4,21,38,55.3,17,24,13,11,46,78,54,0
8481,12,7,6,6,0,8,16,50.0,8,9,4,5,17,29,18,1
8482,6,1,0,3,3,2,9,22.2,7,14,4,10,4,10,29,0
8483,34,17,13,18,3,15,23,65.2,8,27,4,23,22,56,22,0
8484,8,6,2,4,2,3,4,75.0,1,10,0,10,1,9,3,1
8485,7,5,3,2,2,4,8,50.0,4,5,2,3,2,9,7,0
8486,13,10,1,6,6,3,6,50.0,3,6,0,6,2,15,3,0
8487,5,1,1,2,2,3,5,60.0,2,9,0,9,3,8,2,0
8488,8,5,6,1,1,5,7,71.4,2,8,4,4,3,11,8,0
8489,34,20,13,15,6,17,33,51.5,16,22,2,20,18,52,11,0
8490,42,30,32,9,1,16,21,76.2,5,26,15,11,23,65,52,1
8491,13,6,8,3,2,10,15,66.7,5,10,6,4,9,22,63,0
8492,11,10,7,4,0,9,15,60.0,6,1,0,1,9,20,3,0
8493,17,13,10,5,2,10,13,76.9,3,16,7,9,16,33,27,0
8494,1,1,1,0,0,0,0,0.0,0,0,0,0,0,1,0,0
8495,33,22,15,14,4,22,32,68.8,10,31,2,29,12,45,13,1
8496,17,11,6,8,3,4,7,57.1,3,21,3,18,3,20,18,0
8497,8,5,7,1,0,3,6,50.0,3,10,7,3,6,14,26,0
8498,0,0,0,0,0,0,1,0.0,1,1,0,1,0,0,4,0
8499,18,13,5,8,5,10,18,55.6,8,13,0,13,21,39,4,0
8500,26,16,15,10,1,12,26,46.2,14,17,8,9,22,48,36,0
8501,0,0,0,0,0,0,0,0.0,0,0,0,0,0,0,0,0
8502,85,50,50,26,9,49,85,57.6,36,45,12,33,47,132,99,1
8503,90,52,41,43,6,41,85,48.2,44,56,25,31,54,144,72,1
8504,20,10,7,10,3,5,17,29.4,12,19,4,15,9,29,19,1
8505,59,36,22,35,2,26,49,53.1,23,24,5,19,41,100,32,0
8506,13,9,8,2,3,8,12,66.7,4,7,1,6,4,17,10,0
8507,16,10,7,9,0,5,19,26.3,14,14,5,9,14,30,29,3
8508,8,7,2,3,3,2,14,14.3,12,18,0,18,20,28,14,0
8509,14,7,7,4,3,5,14,35.7,9,12,0,12,7,21,12,0
8510,58,35,36,22,0,21,35,60.0,14,27,21,6,44,102,100,1
8511,21,11,5,12,4,4,10,40.0,6,11,1,10,9,30,6,0
8512,28,16,6,16,6,10,22,45.5,12,11,2,9,9,37,2,0
8513,15,10,8,5,2,7,20,35.0,13,7,1,6,5,20,6,1
8514,11,8,8,2,1,8,11,72.7,3,12,9,3,11,22,35,2
8515,50,28,16,32,2,31,62,50.0,31,37,15,22,39,89,64,1
8516,0,0,0,0,0,0,0,0.0,0,1,0,1,0,0,0,0
8517,1,1,0,1,0,1,1,100.0,0,0,0,0,0,1,1,0
8518,15,11,12,2,1,7,16,43.8,9,19,10,9,15,30,67,0
8519,22,15,15,7,0,11,14,78.6,3,25,16,9,8,30,96,0
8520,2,2,2,0,0,2,3,66.7,1,0,0,0,0,2,8,0
8521,6,4,3,3,0,3,4,75.0,1,3,1,2,8,14,15,0
8522,4,3,2,1,1,1,1,100.0,0,2,0,2,0,4,0,0
8523,19,11,13,5,1,7,12,58.3,5,17,9,8,26,45,60,0
8524,7,7,1,5,1,2,7,28.6,5,8,1,7,3,10,7,0
8525,22,14,15,4,3,18,33,54.5,15,23,7,16,14,36,34,0
8526,0,0,0,0,0,0,0,0.0,0,0,0,0,0,0,0,0
8527,2,1,1,0,1,1,2,50.0,1,0,0,0,0,2,0,0
8528,38,17,20,15,3,21,46,45.7,25,28,7,21,22,60,64,0
8529,4,3,1,3,0,2,3,66.7,1,1,0,1,2,6,1,0
8530,19,13,7,7,5,3,14,21.4,11,16,4,12,6,25,11,0
8531,37,21,17,14,6,9,32,28.1,23,16,0,16,15,52,8,0
8532,8,7,5,3,0,5,7,71.4,2,13,8,5,11,19,41,1
8533,44,24,26,10,8,25,45,55.6,20,21,4,17,18,62,45,2
8534,1,0,0,0,1,0,0,0.0,0,0,0,0,1,2,3,0
8535,42,21,14,21,7,14,42,33.3,28,26,4,22,10,52,30,0
8536,8,5,1,6,1,2,6,33.3,4,5,0,5,16,24,10,0
8537,92,65,50,31,11,61,87,70.1,26,26,7,19,70,162,84,2
8538,19,9,6,10,3,12,25,48.0,13,12,1,11,5,24,4,0
8539,3,1,0,2,1,1,2,50.0,1,3,0,3,0,3,4,0
8540,9,6,2,4,3,0,6,0.0,6,8,0,8,0,9,7,0
8541,11,7,0,7,4,4,8,50.0,4,9,4,5,3,14,15,0
8542,46,29,18,24,4,23,38,60.5,15,40,4,36,17,63,32,1
8543,33,23,24,9,0,22,31,71.0,9,21,13,8,26,59,74,1
8544,16,7,1,7,8,6,20,30.0,14,13,1,12,4,20,20,0
8545,8,3,8,0,0,5,7,71.4,2,3,1,2,3,11,12,0
8546,0,0,0,0,0,0,2,0.0,2,1,1,0,1,1,2,0
8547,13,6,3,8,2,4,10,40.0,6,19,0,19,10,23,19,0
8548,1,1,1,0,0,0,3,0.0,3,4,3,1,0,1,19,1
8549,4,3,3,1,0,1,2,50.0,1,0,0,0,1,5,1,0
8550,15,7,3,8,4,4,20,20.0,16,9,2,7,7,22,20,0
8551,7,4,1,5,1,4,8,50.0,4,8,0,8,5,12,4,0
8552,55,32,30,19,6,37,61,60.7,24,29,9,20,31,86,67,1
8553,7,3,3,2,2,3,7,42.9,4,7,1,6,2,9,7,0
8554,3,2,1,1,1,2,4,50.0,2,0,0,0,3,6,3,0
8555,35,26,15,16,4,17,49,34.7,32,36,7,29,22,57,15,0
8556,6,2,0,2,4,1,5,20.0,4,6,2,4,2,8,12,0
8557,11,5,4,4,3,3,5,60.0,2,12,0,12,2,13,3,0
8558,9,4,7,1,1,5,7,71.4,2,7,0,7,2,11,4,0
8559,12,6,7,3,2,3,7,42.9,4,13,3,10,11,23,11,0
8560,13,7,10,3,0,9,11,81.8,2,5,4,1,18,31,23,0
8561,51,27,26,21,4,27,37,73.0,10,14,4,10,21,72,62,0
8562,13,11,3,6,4,1,9,11.1,8,17,5,12,9,22,6,1
8563,2,2,0,2,0,1,5,20.0,4,0,0,0,0,2,0,0
8564,3,2,2,1,0,1,3,33.3,2,3,0,3,1,4,5,0
8565,7,5,4,3,0,6,11,54.5,5,6,1,5,8,15,6,0
8566,2,1,2,0,0,2,4,50.0,2,0,0,0,0,2,16,1
8567,14,8,7,6,1,5,10,50.0,5,12,3,9,8,22,14,0
8568,0,0,0,0,0,0,0,0.0,0,0,0,0,0,0,0,0
8569,53,29,30,19,4,25,58,43.1,33,55,19,36,59,112,93,2
8570,13,8,2,8,3,8,20,40.0,12,11,2,9,2,15,5,0
8571,6,3,2,2,2,2,8,25.0,6,6,0,6,5,11,2,0
8572,2,0,0,1,1,0,3,0.0,3,8,1,7,0,2,3,0
8573,79,49,25,51,3,48,76,63.2,28,37,8,29,37,116,58,0
8574,17,11,10,6,1,6,14,42.9,8,24,14,10,24,41,130,0
8575,54,38,21,19,14,37,54,68.5,17,37,4,33,30,84,32,0
8576,45,24,22,18,5,27,43,62.8,16,41,13,28,29,74,95,0
8577,2,1,1,1,0,0,1,0.0,1,4,0,4,2,4,4,0
8578,12,8,8,3,1,7,12,58.3,5,14,11,3,22,34,51,1
8579,9,8,7,2,0,5,9,55.6,4,14,4,10,15,24,34,0
8580,21,12,10,10,1,13,20,65.0,7,16,3,13,13,34,12,0
8581,35,20,26,6,3,20,43,46.5,23,11,2,9,16,51,45,0
8582,74,52,29,30,15,33,51,64.7,18,37,8,29,49,123,64,1
8583,93,57,42,36,15,46,88,52.3,42,39,10,29,23,116,51,0
8584,22,11,12,7,3,12,26,46.2,14,18,0,18,17,39,10,0
8585,38,26,6,27,5,14,37,37.8,23,24,1,23,13,51,35,0
8586,26,16,18,8,0,9,16,56.3,7,16,8,8,27,53,52,0
8587,5,3,1,3,1,3,3,100.0,0,0,0,0,1,6,0,0
8588,5,4,2,2,1,4,8,50.0,4,1,0,1,3,8,6,0
8589,14,8,6,6,2,4,7,57.1,3,11,1,10,5,19,13,1
8590,22,11,17,5,0,13,18,72.2,5,23,17,6,34,56,61,2
8591,0,0,0,0,0,0,0,0.0,0,1,1,0,0,0,0,0
8592,8,3,4,3,1,5,12,41.7,7,5,2,3,5,13,5,0
8593,26,15,8,13,5,11,28,39.3,17,23,3,20,17,43,22,0
8594,2,1,1,0,1,1,1,100.0,0,0,0,0,1,3,0,0
8595,39,27,24,13,2,25,45,55.6,20,16,5,11,16,55,49,1
8596,0,0,0,0,0,0,0,0.0,0,0,0,0,0,0,0,0
8597,81,52,35,38,8,46,89,51.7,43,39,19,20,52,133,71,0
8598,1,0,0,1,0,1,1,100.0,0,0,0,0,0,1,2,0
8599,1,0,0,0,1,0,0,0.0,0,2,0,2,0,1,0,0
8600,13,8,10,3,0,9,16,56.3,7,12,7,5,11,24,40,0
8601,5,2,1,3,1,2,8,25.0,6,5,0,5,0,5,0,0
8602,6,4,5,1,0,4,6,66.7,2,1,1,0,2,8,4,0
8603,31,19,10,10,11,14,27,51.9,13,24,1,23,13,44,29,0
8604,12,9,0,7,5,3,12,25.0,9,19,1,18,9,21,4,0
8605,0,0,0,0,0,0,0,0.0,0,0,0,0,0,0,2,1
8606,28,20,19,8,1,17,24,70.8,7,15,1,14,10,38,30,1
8607,8,5,6,1,1,5,6,83.3,1,5,3,2,3,11,20,0
8608,19,14,6,10,3,10,25,40.0,15,17,0,17,8,27,12,0
8609,30,14,9,13,8,15,27,55.6,12,19,1,18,26,56,23,0
8610,2,1,1,1,0,1,1,100.0,0,2,0,2,0,2,0,0
8611,36,20,17,17,2,15,36,41.7,21,15,3,12,14,50,7,1
8612,0,0,0,0,0,0,2,0.0,2,0,0,0,1,1,3,0
8613,26,17,11,12,3,10,19,52.6,9,14,6,8,18,44,49,0
8614,7,3,6,1,0,4,8,50.0,4,2,1,1,2,9,6,1
8615,0,0,0,0,0,0,3,0.0,3,2,2,0,1,1,2,0
8616,4,3,0,3,1,1,5,20.0,4,4,0,4,1,5,1,0
8617,4,2,1,1,2,2,3,66.7,1,6,1,5,0,4,0,0
8618,1,1,0,1,0,1,3,33.3,2,0,0,0,2,3,1,0
8619,4,2,0,3,1,1,2,50.0,1,0,0,0,0,4,2,0
8620,5,4,1,3,1,0,1,0.0,1,0,0,0,0,5,0,0
8621,1,0,1,0,0,1,2,50.0,1,0,0,0,2,3,8,1
8622,0,0,0,0,0,0,0,0.0,0,1,0,1,0,0,0,0
8623,52,31,32,18,2,28,42,66.7,14,40,17,23,34,86,124,2
8624,0,0,0,0,0,0,1,0.0,1,0,0,0,1,1,17,5
8625,4,1,1,2,1,4,6,66.7,2,1,1,0,1,5,0,0
8626,78,54,41,27,10,48,78,61.5,30,57,20,37,48,126,126,0
8627,1,1,1,0,0,1,1,100.0,0,1,1,0,1,2,5,0
8628,8,6,4,1,3,2,11,18.2,9,10,2,8,2,10,9,0
8629,21,12,7,13,1,4,14,28.6,10,8,1,7,10,31,6,1
8630,0,0,0,0,0,0,0,0.0,0,0,0,0,0,0,18,1
8631,43,26,29,11,3,22,27,81.5,5,21,17,4,16,59,103,1
8632,76,57,43,26,7,53,81,65.4,28,44,11,33,45,121,66,0
8633,1,1,1,0,0,1,1,100.0,0,0,0,0,1,2,6,1
8634,59,34,24,23,12,22,43,51.2,21,27,4,23,34,93,25,0
8635,1,0,1,0,0,0,1,0.0,1,0,0,0,1,2,0,0
8636,12,4,5,6,1,9,13,69.2,4,7,1,6,6,18,6,0
8637,15,11,6,6,3,6,11,54.5,5,13,5,8,7,22,30,0
8638,0,0,0,0,0,0,0,0.0,0,2,0,2,0,0,3,0
8639,18,7,13,5,0,12,23,52.2,11,28,24,4,22,40,70,1
8640,19,11,4,11,4,11,17,64.7,6,14,4,10,8,27,15,0
8641,44,30,32,10,2,23,57,40.4,34,20,2,18,20,64,48,0
8642,35,19,12,19,4,15,39,38.5,24,28,6,22,32,67,22,0
8643,41,28,20,18,3,21,46,45.7,25,16,3,13,20,61,24,1
8644,0,0,0,0,0,0,0,0.0,0,0,0,0,0,0,0,0
8645,8,7,4,3,1,4,9,44.4,5,18,1,17,6,14,8,0
8646,19,13,4,9,6,9,18,50.0,9,19,7,12,4,23,13,0
8647,0,0,0,0,0,0,0,0.0,0,0,0,0,0,0,4,0
8648,6,2,0,4,2,2,9,22.2,7,7,1,6,2,8,8,0
8649,0,0,0,0,0,0,0,0.0,0,0,0,0,0,0,2,0
8650,0,0,0,0,0,0,1,0.0,1,0,0,0,0,0,17,1
8651,11,7,7,4,0,5,10,50.0,5,4,2,2,4,15,12,0
8652,31,22,18,6,7,22,27,81.5,5,22,1,21,29,60,58,0
8653,11,10,4,6,1,4,9,44.4,5,5,0,5,5,16,3,0
8654,14,9,5,4,5,7,13,53.8,6,5,2,3,5,19,4,0
8655,1,0,0,1,0,0,0,0.0,0,1,0,1,0,1,0,0
8656,1,1,1,0,0,1,1,100.0,0,0,0,0,0,1,13,2
8657,2,1,1,1,0,0,2,0.0,2,7,3,4,4,6,6,0
8658,4,3,4,0,0,0,3,0.0,3,2,0,2,1,5,2,0
8659,39,22,25,12,2,25,37,67.6,12,36,18,18,41,80,116,2
8660,13,11,5,6,2,4,11,36.4,7,10,4,6,5,18,10,0
8661,52,35,40,11,1,29,39,74.4,10,76,53,23,33,85,201,0
8662,55,39,19,24,12,22,44,50.0,22,42,2,40,29,84,31,1
8663,1,1,0,1,0,0,1,0.0,1,5,0,5,1,2,3,0
8664,38,21,12,20,6,19,49,38.8,30,21,6,15,17,55,13,2
8665,40,24,15,19,6,16,32,50.0,16,28,9,19,17,57,24,0
8666,40,25,13,21,6,18,38,47.4,20,20,9,11,23,63,13,0
8667,18,13,6,9,3,6,12,50.0,6,4,1,3,3,21,4,0
8668,0,0,0,0,0,0,0,0.0,0,0,0,0,0,0,1,0
8669,2,2,1,1,0,1,2,50.0,1,2,0,2,0,2,3,0
8670,0,0,0,0,0,0,1,0.0,1,1,1,0,0,0,2,0
8671,10,8,6,4,0,7,11,63.6,4,12,7,5,14,24,29,0
8672,32,17,9,17,6,17,37,45.9,20,24,5,19,11,43,38,1
8673,15,7,7,5,3,6,19,31.6,13,10,1,9,6,21,12,0
8674,6,5,1,2,3,4,7,57.1,3,6,3,3,6,12,4,0
8675,10,6,3,4,3,2,5,40.0,3,6,1,5,3,13,4,0
8676,17,9,3,9,5,7,16,43.8,9,8,0,8,8,25,14,0
8677,29,15,14,14,1,14,25,56.0,11,11,4,7,10,39,14,0
8678,4,4,1,1,2,0,1,0.0,1,4,1,3,2,6,2,0
8679,32,16,23,8,1,15,33,45.5,18,30,20,10,35,67,100,1
8680,62,48,37,21,4,35,54,64.8,19,80,56,24,70,132,250,4
8681,50,27,27,17,6,23,60,38.3,37,40,2,38,24,74,36,0
8682,47,29,26,16,5,25,44,56.8,19,31,13,18,30,77,62,0
8683,12,6,6,4,2,2,6,33.3,4,10,1,9,5,17,2,0
8684,38,30,19,13,6,21,39,53.8,18,14,0,14,17,55,27,0
8685,4,4,2,1,1,4,5,80.0,1,5,0,5,1,5,10,0
8686,22,19,11,4,7,9,14,64.3,5,15,4,11,10,32,9,1
8687,15,6,13,2,0,9,14,64.3,5,20,13,7,19,34,41,1
8688,1,1,0,1,0,0,2,0.0,2,0,0,0,1,2,0,0
8689,1,1,1,0,0,1,3,33.3,2,0,0,0,0,1,8,0
8690,48,32,27,21,0,17,28,60.7,11,36,25,11,36,84,107,0
8691,22,17,10,7,5,11,22,50.0,11,9,1,8,6,28,6,0
8692,18,11,12,6,0,6,11,54.5,5,13,5,8,12,30,61,1
8693,39,27,11,17,11,20,44,45.5,24,21,0,21,10,49,7,0
8694,24,15,14,7,3,10,24,41.7,14,14,2,12,24,48,24,0
8695,36,22,12,22,2,20,37,54.1,17,14,3,11,15,51,22,0
8696,0,0,0,0,0,0,0,0.0,0,0,0,0,0,0,0,0
8697,0,0,0,0,0,0,0,0.0,0,3,3,0,1,1,4,0
8698,9,9,1,5,3,5,12,41.7,7,4,0,4,2,11,3,0
8699,43,21,21,17,5,21,45,46.7,24,23,8,15,20,63,15,0
8700,1,1,1,0,0,1,1,100.0,0,0,0,0,0,1,1,0
8701,1,1,0,1,0,1,1,100.0,0,0,0,0,1,2,2,0
8702,66,46,34,24,8,46,74,62.2,28,65,10,55,35,101,49,0
8703,0,0,0,0,0,0,0,0.0,0,0,0,0,0,0,0,0
8704,2,0,0,1,1,0,0,0.0,0,0,0,0,0,2,1,0
8705,7,5,0,7,0,4,7,57.1,3,5,1,4,3,10,8,0
8706,63,36,40,19,4,35,65,53.8,30,33,7,26,36,99,77,0
8707,32,22,5,21,6,13,45,28.9,32,6,0,6,9,41,2,0
8708,10,7,5,3,2,3,21,14.3,18,7,0,7,13,23,1,0
8709,16,13,10,4,2,10,15,66.7,5,3,1,2,10,26,53,0
8710,21,17,12,7,2,12,25,48.0,13,7,4,3,8,29,10,0
8711,49,36,27,21,1,22,33,66.7,11,30,16,14,38,87,90,0
8712,3,2,1,2,0,1,1,100.0,0,0,0,0,0,3,0,0
8713,27,20,8,14,5,18,52,34.6,34,21,5,16,13,40,13,0
8714,9,6,6,1,2,4,5,80.0,1,6,5,1,8,17,15,0
8715,0,0,0,0,0,0,2,0.0,2,1,0,1,0,0,0,0
8716,12,6,6,5,1,4,20,20.0,16,20,6,14,12,24,25,0
8717,73,44,35,25,13,27,74,36.5,47,20,2,18,17,90,27,1
8718,30,15,12,11,7,12,36,33.3,24,24,2,22,10,40,14,0
8719,0,0,0,0,0,0,0,0.0,0,1,1,0,0,0,1,0
8720,5,4,4,1,0,3,3,100.0,0,3,2,1,7,12,9,0
8721,10,7,8,1,1,5,8,62.5,3,2,1,1,0,10,1,0
8722,13,4,10,3,0,8,18,44.4,10,20,9,11,22,35,72,0
8723,29,18,16,13,0,8,18,44.4,10,21,16,5,13,42,58,0
8724,0,0,0,0,0,0,0,0.0,0,0,0,0,1,1,0,0
8725,0,0,0,0,0,0,1,0.0,1,1,0,1,0,0,7,0
8726,2,0,1,0,1,1,1,100.0,0,1,0,1,0,2,1,0
8727,0,0,0,0,0,0,0,0.0,0,0,0,0,0,0,0,0
8728,50,33,34,15,1,22,36,61.1,14,39,29,10,40,90,143,1
8729,25,12,12,12,1,10,28,35.7,18,7,0,7,12,37,14,0
8730,9,8,4,4,1,6,13,46.2,7,4,0,4,3,12,4,0
8731,8,5,5,2,1,6,13,46.2,7,4,0,4,3,11,5,0
8732,63,40,35,27,1,30,56,53.6,26,40,13,27,32,95,41,1
8733,9,3,7,2,0,3,7,42.9,4,3,2,1,7,16,15,0
8734,8,3,4,3,1,1,1,100.0,0,2,1,1,1,9,2,0
8735,10,5,7,3,0,6,11,54.5,5,7,1,6,7,17,11,0
8736,1,1,1,0,0,1,1,100.0,0,1,0,1,1,2,9,1
8737,49,30,25,17,7,24,52,46.2,28,38,5,33,35,84,38,3
8738,0,0,0,0,0,0,0,0.0,0,0,0,0,0,0,1,0
8739,2,0,2,0,0,2,2,100.0,0,3,2,1,1,3,7,0
8740,5,5,4,1,0,3,3,100.0,0,5,3,2,4,9,22,1
8741,5,3,1,2,2,2,5,40.0,3,11,2,9,1,6,7,0
8742,11,6,3,3,5,5,12,41.7,7,4,2,2,5,16,17,0
8743,8,5,3,3,2,4,6,66.7,2,4,1,3,3,11,6,0
8744,48,30,31,12,5,22,31,71.0,9,35,19,16,24,72,111,1
8745,9,6,1,6,2,4,8,50.0,4,12,0,12,4,13,17,0
8746,6,4,1,3,2,3,6,50.0,3,10,3,7,1,7,9,0
8747,14,7,5,5,4,9,25,36.0,16,7,0,7,4,18,6,0
8748,14,10,4,9,1,7,18,38.9,11,9,2,7,10,24,11,1
8749,11,7,3,7,1,4,9,44.4,5,11,5,6,15,26,16,0
8750,0,0,0,0,0,0,0,0.0,0,0,0,0,0,0,0,0
8751,4,3,4,0,0,3,3,100.0,0,1,0,1,3,7,10,0
8752,17,9,8,7,2,8,13,61.5,5,7,1,6,6,23,15,0
8753,33,24,20,8,5,20,42,47.6,22,21,2,19,17,50,29,0
8754,2,2,2,0,0,2,3,66.7,1,0,0,0,0,2,14,4
8755,20,16,6,11,3,12,21,57.1,9,12,4,8,7,27,13,0
8756,0,0,0,0,0,0,0,0.0,0,0,0,0,1,1,2,2
8757,14,9,5,7,2,8,16,50.0,8,12,0,12,11,25,8,0
8758,18,11,13,5,0,14,22,63.6,8,24,9,15,25,43,51,0
8759,1,0,0,1,0,1,3,33.3,2,4,1,3,0,1,4,0
8760,43,22,19,18,6,24,40,60.0,16,18,0,18,18,61,36,1
8761,42,29,27,10,5,24,41,58.5,17,26,10,16,23,65,35,1
8762,6,4,2,3,1,2,4,50.0,2,4,1,3,2,8,9,0
8763,5,3,3,1,1,2,3,66.7,1,2,0,2,0,5,2,0
8764,44,30,17,14,13,22,56,39.3,34,38,3,35,10,54,21,1
8765,16,9,0,11,5,5,13,38.5,8,11,2,9,3,19,9,0
8766,29,19,14,8,7,19,34,55.9,15,7,0,7,17,46,30,0
8767,5,2,4,1,0,2,4,50.0,2,6,4,2,5,10,22,0
8768,15,11,5,6,4,8,16,50.0,8,13,2,11,11,26,25,0
8769,53,37,21,24,8,29,48,60.4,19,17,3,14,23,76,41,0
8770,1,0,0,1,0,1,1,100.0,0,0,0,0,0,1,0,0
8771,45,23,14,23,8,21,34,61.8,13,20,1,19,16,61,4,0
8772,23,18,4,16,3,10,26,38.5,16,10,2,8,7,30,9,0
8773,3,2,1,1,1,2,2,100.0,0,0,0,0,1,4,0,0
8774,39,21,26,10,3,25,52,48.1,27,23,10,13,36,75,100,0
8775,21,9,6,12,3,6,27,22.2,21,10,0,10,7,28,8,0
8776,5,2,3,1,1,1,3,33.3,2,4,0,4,0,5,12,1
8777,36,19,18,9,9,13,41,31.7,28,22,1,21,18,54,3,1
8778,0,0,0,0,0,0,0,0.0,0,2,1,1,0,0,0,0
8779,58,37,23,26,9,25,52,48.1,27,33,5,28,27,85,32,1
8780,0,0,0,0,0,0,1,0.0,1,0,0,0,0,0,1,0
8781,5,4,4,0,1,3,8,37.5,5,8,0,8,1,6,4,0
8782,12,9,9,2,1,8,13,61.5,5,24,11,13,16,28,52,0
8783,16,10,8,5,3,10,15,66.7,5,3,0,3,5,21,10,0
8784,28,18,14,14,0,11,27,40.7,16,17,8,9,23,51,35,0
8785,23,13,11,10,2,7,24,29.2,17,13,1,12,5,28,33,0
8786,5,3,1,3,1,1,11,9.1,10,3,0,3,0,5,8,0
8787,0,0,0,0,0,0,0,0.0,0,0,0,0,1,1,12,1
8788,26,15,14,11,1,10,15,66.7,5,13,7,6,19,45,67,0
8789,0,0,0,0,0,0,0,0.0,0,1,0,1,0,0,3,0
8790,2,1,2,0,0,1,2,50.0,1,0,0,0,0,2,0,0
8791,1,1,0,1,0,0,0,0.0,0,0,0,0,0,1,1,0
8792,38,23,12,23,3,13,43,30.2,30,22,3,19,12,50,16,0
8793,0,0,0,0,0,0,2,0.0,2,5,1,4,2,2,1,0
8794,29,15,17,12,0,17,27,63.0,10,19,3,16,10,39,31,0
8795,9,5,7,2,0,6,19,31.6,13,6,1,5,6,15,8,0
8796,1,1,0,1,0,1,1,100.0,0,0,0,0,0,1,0,0
8797,0,0,0,0,0,0,0,0.0,0,0,0,0,3,3,2,0
8798,0,0,0,0,0,0,1,0.0,1,0,0,0,0,0,3,0
8799,29,20,9,16,4,10,33,30.3,23,32,5,27,18,47,17,0
8800,21,13,14,5,2,12,20,60.0,8,25,14,11,19,40,54,1
8801,18,11,9,9,0,9,25,36.0,16,14,8,6,3,21,25,0
8802,60,37,33,20,7,32,48,66.7,16,40,15,25,41,101,82,1
8803,4,4,2,2,0,2,8,25.0,6,4,0,4,5,9,2,0
8804,50,32,26,16,8,23,37,62.2,14,15,6,9,26,76,48,0
8805,39,21,6,24,9,15,40,37.5,25,29,7,22,16,55,19,1
8806,11,8,3,4,4,4,4,100.0,0,2,1,1,0,11,3,0
8807,1,1,0,0,1,1,4,25.0,3,4,0,4,0,1,0,0
8808,3,2,3,0,0,0,1,0.0,1,5,2,3,5,8,23,1
8809,1,1,0,0,1,1,1,100.0,0,1,1,0,2,3,2,0
8810,0,0,0,0,0,0,0,0.0,0,0,0,0,0,0,0,0
8811,0,0,0,0,0,0,1,0.0,1,0,0,0,0,0,7,1
8812,29,14,13,10,6,18,42,42.9,24,13,0,13,7,36,7,0
8813,32,19,16,14,2,17,35,48.6,18,25,14,11,20,52,33,0
8814,20,12,7,12,1,7,20,35.0,13,7,0,7,8,28,1,0
8815,2,2,0,2,0,0,1,0.0,1,2,1,1,4,6,3,0
8816,0,0,0,0,0,0,0,0.0,0,0,0,0,0,0,2,0
8817,15,11,5,8,2,8,30,26.7,22,17,3,14,5,20,21,0
8818,9,6,3,5,1,4,12,33.3,8,6,3,3,11,20,48,0
8819,30,22,16,8,6,15,22,68.2,7,24,6,18,31,61,64,1
8820,68,41,43,18,7,41,75,54.7,34,44,11,33,51,119,75,2
8821,0,0,0,0,0,0,0,0.0,0,0,0,0,0,0,0,0
8822,6,2,0,4,2,0,7,0.0,7,10,2,8,1,7,9,0
8823,40,24,13,23,4,31,53,58.5,22,19,5,14,13,53,15,0
8824,11,8,8,3,0,4,10,40.0,6,10,7,3,30,41,49,1
8825,3,1,2,1,0,2,2,100.0,0,2,2,0,2,5,6,1
8826,1,0,0,1,0,1,1,100.0,0,1,0,1,1,2,4,0
8827,33,17,20,12,1,14,21,66.7,7,9,4,5,19,52,57,1
8828,23,13,3,13,7,15,31,48.4,16,17,1,16,4,27,7,0
8829,26,17,17,9,0,14,23,60.9,9,21,7,14,8,34,51,0
8830,21,14,7,12,2,7,21,33.3,14,34,3,31,2,23,20,0
8831,31,21,22,4,5,15,39,38.5,24,15,3,12,16,47,39,0
8832,30,21,16,11,3,16,32,50.0,16,10,0,10,10,40,19,0
8833,0,0,0,0,0,0,0,0.0,0,0,0,0,0,0,0,0
8834,23,21,8,12,3,14,23,60.9,9,15,4,11,8,31,9,0
8835,22,9,10,9,3,13,25,52.0,12,17,4,13,9,31,7,0
8836,5,2,2,2,1,2,7,28.6,5,2,1,1,2,7,2,0
8837,68,48,41,25,2,35,65,53.8,30,52,32,20,47,115,185,0
8838,65,39,37,26,2,31,52,59.6,21,39,21,18,63,128,132,0
8839,24,16,15,6,3,16,26,61.5,10,16,2,14,7,31,15,1
8840,37,26,30,6,1,18,26,69.2,8,50,30,20,46,83,152,2
8841,28,15,4,15,9,12,32,37.5,20,24,1,23,14,42,2,0
8842,20,13,12,7,1,11,26,42.3,15,19,6,13,17,37,24,0
8843,30,24,17,9,4,19,29,65.5,10,9,2,7,8,38,9,0
8844,35,23,17,14,4,21,34,61.8,13,8,2,6,25,60,37,1
8845,0,0,0,0,0,0,1,0.0,1,0,0,0,0,0,0,0
8846,44,29,25,14,5,23,42,54.8,19,21,2,19,21,65,42,0
8847,35,29,7,21,7,12,23,52.2,11,27,4,23,13,48,43,0
8848,13,9,5,5,3,4,14,28.6,10,19,2,17,11,24,12,0
8849,4,1,2,1,1,2,11,18.2,9,12,4,8,5,9,11,0
8850,33,20,11,14,8,6,30,20.0,24,10,0,10,11,44,6,0
8851,63,45,34,23,6,41,59,69.5,18,32,13,19,35,98,120,0
8852,3,1,3,0,0,3,3,100.0,0,0,0,0,0,3,18,2
8853,4,3,3,1,0,4,8,50.0,4,2,1,1,2,6,7,0
8854,7,4,2,5,0,2,2,100.0,0,9,1,8,3,10,0,0
8855,49,25,14,24,11,16,44,36.4,28,42,0,42,31,80,14,2
8856,1,1,1,0,0,1,2,50.0,1,0,0,0,0,1,17,6
8857,16,9,7,7,2,8,8,100.0,0,8,1,7,8,24,15,0
8858,8,6,2,5,1,4,8,50.0,4,2,0,2,3,11,8,0
8859,18,10,10,6,2,14,22,63.6,8,9,3,6,11,29,23,0
8860,18,13,9,5,4,9,15,60.0,6,7,4,3,5,23,9,1
8861,16,8,6,6,4,8,19,42.1,11,13,0,13,5,21,10,0
8862,21,13,4,17,0,9,29,31.0,20,24,4,20,13,34,15,0
8863,15,9,3,10,2,5,16,31.3,11,5,1,4,7,22,17,0
8864,41,25,20,17,4,21,36,58.3,15,10,4,6,25,66,15,0
8865,20,12,15,4,1,9,14,64.3,5,21,8,13,31,51,90,0
8866,11,4,5,5,1,6,17,35.3,11,10,4,6,1,12,6,0
8867,21,7,5,8,8,9,18,50.0,9,18,4,14,6,27,30,1
8868,5,3,2,2,1,2,6,33.3,4,4,0,4,2,7,1,0
8869,39,25,21,18,0,22,40,55.0,18,28,11,17,45,84,66,3
8870,21,15,6,11,4,6,20,30.0,14,23,1,22,16,37,4,1
8871,0,0,0,0,0,0,0,0.0,0,0,0,0,0,0,0,0
8872,21,15,10,9,2,3,9,33.3,6,12,2,10,12,33,18,0
8873,45,29,34,10,1,25,37,67.6,12,44,23,21,49,94,81,3
8874,1,0,1,0,0,0,2,0.0,2,0,0,0,2,3,3,0
8875,8,4,1,4,3,5,14,35.7,9,2,0,2,13,21,2,0
8876,62,29,48,14,0,30,50,60.0,20,41,24,17,38,100,143,2
8877,1,1,1,0,0,1,1,100.0,0,1,0,1,3,4,18,2
8878,9,6,2,5,2,4,10,40.0,6,18,4,14,2,11,25,0
8879,3,3,2,1,0,1,1,100.0,0,2,2,0,3,6,6,0
8880,0,0,0,0,0,0,0,0.0,0,1,0,1,0,0,0,0
8881,13,5,3,7,3,6,12,50.0,6,3,0,3,2,15,2,0
8882,10,11,3,4,3,5,11,45.5,6,4,1,3,8,18,14,0
8883,48,28,25,21,2,27,58,46.6,31,43,8,35,20,68,42,1
8884,66,39,30,28,8,27,67,40.3,40,50,6,44,16,82,27,0
8885,27,17,15,10,2,19,30,63.3,11,31,18,13,19,46,70,0
8886,32,20,23,7,2,18,27,66.7,9,20,15,5,31,63,101,1
8887,23,17,18,5,0,8,13,61.5,5,23,16,7,26,49,106,1
8888,3,3,1,2,0,3,8,37.5,5,4,1,3,2,5,1,0
8889,18,13,8,5,5,13,28,46.4,15,14,0,14,7,25,8,0
8890,6,5,3,3,0,4,11,36.4,7,4,0,4,5,11,7,0
8891,18,11,4,10,4,8,17,47.1,9,6,2,4,0,18,16,0
8892,49,28,21,17,11,23,53,43.4,30,28,4,24,11,60,28,0
8893,40,22,17,18,5,19,73,26.0,54,31,3,28,15,55,23,0
8894,58,41,28,25,5,34,81,42.0,47,28,1,27,24,82,34,1
8895,3,2,2,1,0,0,0,0.0,0,0,0,0,2,5,3,0
8896,1,0,0,0,1,0,0,0.0,0,2,0,2,0,1,2,0
8897,5,5,4,1,0,2,5,40.0,3,0,0,0,0,5,1,0
8898,69,48,30,33,6,33,52,63.5,19,47,8,39,44,113,41,0
8899,5,4,1,3,1,3,5,60.0,2,2,0,2,2,7,3,0
8900,0,0,0,0,0,0,1,0.0,1,0,0,0,0,0,6,1
8901,53,34,25,25,3,23,47,48.9,24,21,8,13,31,84,82,1
8902,8,4,6,2,0,3,7,42.9,4,11,6,5,9,17,39,1
8903,22,13,17,5,0,12,20,60.0,8,33,23,10,30,52,132,2
8904,3,1,1,2,0,2,2,100.0,0,3,1,2,1,4,1,0
8905,19,16,15,4,0,9,14,64.3,5,10,5,5,7,26,44,1
8906,0,0,0,0,0,0,0,0.0,0,0,0,0,0,0,3,0
8907,5,3,1,2,2,2,2,100.0,0,4,2,2,2,7,11,0
8908,0,0,0,0,0,0,0,0.0,0,0,0,0,0,0,2,0
8909,21,11,12,8,1,12,14,85.7,2,28,24,4,22,43,126,4
8910,37,21,25,11,1,17,29,58.6,12,32,21,11,29,66,130,2
8911,21,10,2,15,4,12,33,36.4,21,23,2,21,18,39,24,0
8912,44,24,28,14,2,21,34,61.8,13,38,22,16,23,67,64,1
8913,0,0,0,0,0,0,1,0.0,1,0,0,0,0,0,0,0
8914,80,46,24,48,8,31,57,54.4,26,20,7,13,21,101,32,0
8915,15,7,11,3,1,6,12,50.0,6,7,0,7,5,20,7,0
8916,67,33,24,38,5,31,69,44.9,38,29,5,24,10,77,31,0
8917,59,42,39,16,4,25,46,54.3,21,30,6,24,28,87,40,0
8918,14,11,6,6,2,11,15,73.3,4,7,0,7,6,20,6,0
8919,19,10,15,4,0,14,26,53.8,12,18,11,7,20,39,50,0
8920,7,4,2,3,2,4,7,57.1,3,4,0,4,3,10,7,0
8921,28,15,15,12,1,11,18,61.1,7,30,17,13,27,55,99,1
8922,4,3,1,1,2,3,5,60.0,2,4,1,3,4,8,1,0
8923,20,15,10,8,2,9,16,56.3,7,12,1,11,14,34,5,2
8924,55,37,40,15,0,29,40,72.5,11,51,35,16,26,81,134,2
8925,24,15,18,5,1,13,28,46.4,15,34,17,17,20,44,45,3
8926,13,8,5,7,1,4,13,30.8,9,8,2,6,9,22,22,0
8927,1,1,0,1,0,0,2,0.0,2,2,0,2,1,2,0,0
8928,4,2,1,2,1,1,1,100.0,0,0,0,0,0,4,2,0
8929,48,26,34,10,4,33,60,55.0,27,33,12,21,29,77,54,0
8930,7,3,2,3,2,2,2,100.0,0,1,0,1,6,13,5,0
8931,6,3,3,3,0,1,10,10.0,9,2,0,2,1,7,3,0
8932,1,0,1,0,0,0,1,0.0,1,0,0,0,0,1,0,0
8933,1,0,0,1,0,0,0,0.0,0,0,0,0,1,2,0,0
8934,23,15,11,8,4,16,19,84.2,3,16,13,3,11,34,59,1
8935,14,9,4,8,2,9,18,50.0,9,16,2,14,11,25,23,0
8936,3,3,2,1,0,3,5,60.0,2,4,4,0,6,9,26,1
8937,13,8,4,4,5,3,13,23.1,10,18,1,17,2,15,12,0
8938,0,0,0,0,0,0,0,0.0,0,0,0,0,0,0,0,0
8939,0,0,0,0,0,0,1,0.0,1,1,0,1,1,1,1,0
8940,0,0,0,0,0,0,0,0.0,0,0,0,0,1,1,1,0
8941,2,1,0,2,0,1,1,100.0,0,0,0,0,0,2,0,0
8942,19,13,10,9,0,10,19,52.6,9,9,3,6,16,35,25,3
8943,6,2,2,3,1,5,6,83.3,1,3,0,3,2,8,0,1
8944,45,31,24,17,4,26,44,59.1,18,34,6,28,23,68,53,0
8945,37,29,20,15,2,19,43,44.2,24,9,3,6,18,55,27,1
8946,2,1,1,0,1,1,5,20.0,4,0,0,0,1,3,0,0
8947,13,8,7,4,2,8,13,61.5,5,7,3,4,9,22,30,0
8948,14,8,7,6,1,9,15,60.0,6,9,4,5,2,16,10,0
8949,4,2,1,0,3,3,12,25.0,9,6,3,3,1,5,3,0
8950,3,3,3,0,0,2,5,40.0,3,1,1,0,3,6,7,0
8951,2,2,1,1,0,1,1,100.0,0,0,0,0,1,3,4,0
8952,1,1,1,0,0,1,1,100.0,0,0,0,0,0,1,1,0
8953,16,11,3,7,6,9,16,56.3,7,12,1,11,7,23,5,0
8954,25,19,7,8,10,12,32,37.5,20,25,2,23,8,33,6,0
8955,72,39,48,22,2,21,42,50.0,21,62,41,21,48,120,148,3
8956,29,19,7,15,7,12,23,52.2,11,13,1,12,18,47,15,0
8957,41,28,21,14,6,24,31,77.4,7,31,19,12,32,73,100,1
8958,9,6,2,6,1,4,12,33.3,8,10,0,10,3,12,3,0
8959,21,11,4,11,6,8,21,38.1,13,12,2,10,3,24,4,0
8960,31,14,22,5,4,14,25,56.0,11,16,4,12,22,53,43,0
8961,1,1,1,0,0,0,0,0.0,0,2,0,2,2,3,0,0
8962,39,24,11,22,6,21,35,60.0,14,29,10,19,33,72,84,0
8963,1,0,0,0,1,0,0,0.0,0,2,0,2,0,1,3,0
8964,6,5,1,5,0,3,4,75.0,1,4,0,4,0,6,8,0
8965,4,3,2,2,0,3,7,42.9,4,1,0,1,0,4,3,0
8966,15,10,10,5,0,8,12,66.7,4,7,0,7,6,21,35,0
8967,5,4,1,4,0,1,8,12.5,7,3,0,3,5,10,8,0
8968,18,11,8,9,1,10,17,58.8,7,21,10,11,24,42,70,0
8969,1,1,1,0,0,1,2,50.0,1,1,0,1,0,1,0,0
8970,47,28,12,25,10,18,50,36.0,32,28,2,26,10,57,13,0
8971,24,12,14,8,2,17,19,89.5,2,20,9,11,21,45,59,0
8972,0,0,0,0,0,0,0,0.0,0,0,0,0,0,0,0,0
8973,0,0,0,0,0,0,0,0.0,0,0,0,0,0,0,2,1
8974,77,52,38,29,10,34,86,39.5,52,62,13,49,33,110,65,1
8975,0,0,0,0,0,0,2,0.0,2,0,0,0,1,1,18,1
8976,1,0,1,0,0,0,0,0.0,0,0,0,0,0,1,0,0
8977,2,1,2,0,0,0,1,0.0,1,0,0,0,0,2,0,0
8978,31,19,24,7,0,16,41,39.0,25,28,21,7,38,69,123,2
8979,40,23,11,15,14,16,31,51.6,15,20,6,14,20,60,43,0
8980,0,0,0,0,0,0,0,0.0,0,0,0,0,0,0,3,0
8981,66,54,34,28,4,36,67,53.7,31,21,6,15,28,94,33,1
8982,30,16,12,13,5,11,29,37.9,18,13,2,11,11,41,18,0
8983,1,0,1,0,0,1,2,50.0,1,0,0,0,0,1,9,1
8984,39,25,22,15,2,21,46,45.7,25,37,12,25,28,67,49,1
8985,3,2,1,1,1,1,5,20.0,4,2,0,2,4,7,5,0
8986,0,0,0,0,0,0,3,0.0,3,0,0,0,0,0,10,2
8987,55,33,19,30,6,26,65,40.0,39,46,10,36,36,91,26,0
8988,3,3,1,1,1,1,1,100.0,0,3,0,3,1,4,2,0
8989,3,2,1,2,0,1,2,50.0,1,4,0,4,1,4,2,0
8990,22,12,10,10,2,15,30,50.0,15,27,6,21,11,33,24,0
8991,0,0,0,0,0,0,0,0.0,0,0,0,0,0,0,0,0
8992,28,17,13,12,3,17,36,47.2,19,21,2,19,10,38,15,0
8993,43,22,9,20,14,28,57,49.1,29,30,7,23,18,61,26,0
8994,46,27,29,13,4,27,38,71.1,11,31,15,16,16,62,70,0
8995,12,9,2,5,5,2,9,22.2,7,30,4,26,6,18,19,0
8996,1,0,1,0,0,1,2,50.0,1,6,1,5,2,3,14,0
8997,12,10,4,7,1,7,11,63.6,4,3,0,3,8,20,7,0
8998,9,3,3,3,3,4,8,50.0,4,13,2,11,3,12,8,0
8999,5,3,5,0,0,2,10,20.0,8,13,9,4,10,15,48,1
9000,22,17,7,10,5,8,33,24.2,25,30,0,30,13,35,23,0
9001,1,1,0,0,1,1,1,100.0,0,2,0,2,2,3,1,0
9002,41,22,25,14,2,22,27,81.5,5,32,19,13,16,57,119,0
9003,9,3,5,3,1,5,14,35.7,9,5,1,4,4,13,13,0
9004,39,27,15,18,6,18,41,43.9,23,33,10,23,35,74,39,0
9005,7,5,6,1,0,3,10,30.0,7,9,0,9,13,20,1,0
9006,43,31,30,12,1,29,54,53.7,25,17,7,10,16,59,17,0
9007,59,32,27,28,4,24,51,47.1,27,28,3,25,24,83,43,2
9008,26,14,17,7,2,19,29,65.5,10,22,2,20,10,36,39,0
9009,5,3,2,2,1,1,3,33.3,2,6,1,5,1,6,0,0
9010,19,12,9,9,1,8,20,40.0,12,18,3,15,2,21,14,0
9011,6,3,2,3,1,1,7,14.3,6,4,1,3,0,6,5,0
9012,9,6,6,3,0,3,4,75.0,1,2,1,1,6,15,14,0
9013,0,0,0,0,0,0,0,0.0,0,0,0,0,0,0,2,1
9014,2,1,0,1,1,1,1,100.0,0,3,0,3,2,4,3,0
9015,16,12,9,6,1,9,15,60.0,6,32,22,10,9,25,86,0
9016,47,31,23,20,4,19,47,40.4,28,39,8,31,22,69,27,1
9017,10,6,1,4,5,6,11,54.5,5,9,1,8,4,14,26,0
9018,91,65,25,52,14,43,77,55.8,34,44,17,27,54,145,32,0
9019,0,0,0,0,0,0,1,0.0,1,4,1,3,0,0,0,0
9020,1,1,0,1,0,1,1,100.0,0,2,2,0,1,2,6,0
9021,45,30,23,19,3,27,39,69.2,12,19,0,19,13,58,16,1
9022,41,27,15,17,9,23,38,60.5,15,35,0,35,8,49,5,0
9023,2,1,0,1,1,1,1,100.0,0,4,0,4,1,3,3,0
9024,38,22,11,24,3,13,24,54.2,11,16,1,15,7,45,6,0
9025,3,2,0,2,1,1,2,50.0,1,3,0,3,0,3,1,0
9026,0,0,0,0,0,0,0,0.0,0,3,2,1,1,1,1,0
9027,35,24,12,16,7,12,36,33.3,24,12,0,12,6,41,14,0
9028,48,36,14,24,10,21,59,35.6,38,34,4,30,14,62,11,1
9029,31,15,9,21,1,16,22,72.7,6,9,4,5,19,50,24,0
9030,0,0,0,0,0,0,0,0.0,0,0,0,0,0,0,6,0
9031,0,0,0,0,0,0,0,0.0,0,1,0,1,0,0,0,0
9032,28,21,10,13,5,8,24,33.3,16,15,1,14,7,35,3,1
9033,57,27,20,32,5,26,57,45.6,31,53,15,38,42,99,51,0
9034,54,32,21,27,6,18,39,46.2,21,19,2,17,17,71,23,1
9035,32,19,9,16,7,16,37,43.2,21,19,2,17,17,49,11,0
9036,5,3,2,2,1,1,3,33.3,2,1,0,1,2,7,1,0
9037,6,3,1,3,2,5,9,55.6,4,6,1,5,3,9,5,0
9038,30,21,15,10,5,13,44,29.5,31,16,3,13,18,48,7,0
9039,60,38,30,25,5,23,54,42.6,31,38,9,29,26,86,32,0
9040,0,0,0,0,0,0,0,0.0,0,0,0,0,0,0,3,0
9041,0,0,0,0,0,0,0,0.0,0,0,0,0,1,1,0,0
9042,6,5,6,0,0,4,6,66.7,2,4,1,3,4,10,18,0
9043,34,17,14,16,4,14,24,58.3,10,21,6,15,10,44,17,0
9044,2,2,1,1,0,1,3,33.3,2,1,0,1,1,3,0,0
9045,7,4,6,1,0,3,5,60.0,2,1,0,1,1,8,5,0
9046,109,67,69,34,6,66,108,61.1,42,39,10,29,53,162,47,0
9047,41,23,30,9,2,19,44,43.2,25,9,5,4,23,64,61,0
9048,11,4,8,3,0,4,7,57.1,3,20,16,4,10,21,53,0
9049,0,0,0,0,0,0,1,0.0,1,0,0,0,1,1,23,2
9050,2,1,0,1,1,0,3,0.0,3,0,0,0,1,3,0,0
9051,10,6,5,4,1,3,5,60.0,2,6,3,3,6,16,3,0
9052,34,26,24,7,3,15,19,78.9,4,19,9,10,21,55,44,1
9053,6,5,3,1,2,1,5,20.0,4,4,1,3,4,10,3,0
9054,2,1,0,1,1,1,4,25.0,3,9,5,4,4,6,8,1
9055,29,15,7,17,5,12,27,44.4,15,20,3,17,11,40,10,0
9056,0,0,0,0,0,0,0,0.0,0,0,0,0,0,0,1,0
9057,79,46,25,43,11,42,75,56.0,33,42,21,21,38,117,57,1
9058,2,1,1,1,0,0,2,0.0,2,4,3,1,3,5,14,0
9059,18,11,14,3,1,10,17,58.8,7,13,7,6,18,36,57,0
9060,0,0,0,0,0,0,0,0.0,0,0,0,0,0,0,7,0
9061,25,17,18,7,0,17,20,85.0,3,33,26,7,36,61,136,1
9062,2,2,2,0,0,0,1,0.0,1,0,0,0,2,4,1,0
9063,26,13,12,9,5,16,25,64.0,9,17,2,15,14,40,21,0
9064,54,30,23,29,2,31,65,47.7,34,23,9,14,45,99,44,3
9065,29,20,15,11,3,12,17,70.6,5,19,11,8,20,49,43,0
9066,17,9,12,3,2,5,11,45.5,6,9,3,6,14,31,37,1
9067,34,20,19,13,2,22,29,75.9,7,46,27,19,32,66,90,1
9068,14,9,4,7,3,7,13,53.8,6,13,5,8,1,15,23,0
9069,30,15,22,4,4,15,31,48.4,16,23,8,15,27,57,35,0
9070,2,0,1,1,0,1,4,25.0,3,3,0,3,0,2,1,0
9071,17,9,7,7,3,13,21,61.9,8,7,1,6,6,23,7,0
9072,8,6,1,5,2,1,4,25.0,3,15,4,11,7,15,13,0
9073,1,0,0,1,0,0,0,0.0,0,0,0,0,4,5,4,0
9074,3,3,2,1,0,2,6,33.3,4,2,0,2,0,3,7,0
9075,0,0,0,0,0,0,1,0.0,1,0,0,0,0,0,0,0
9076,28,15,10,14,4,15,28,53.6,13,20,2,18,16,44,18,1
9077,30,23,20,9,1,22,32,68.8,10,30,20,10,35,65,92,0
9078,10,7,2,6,2,5,13,38.5,8,15,3,12,3,13,20,0
9079,7,5,4,1,2,3,10,30.0,7,3,0,3,1,8,1,0
9080,23,11,15,8,0,13,20,65.0,7,21,14,7,15,38,71,0
9081,14,7,7,5,2,9,12,75.0,3,13,5,8,3,17,7,0
9082,16,6,6,8,2,7,12,58.3,5,11,2,9,2,18,15,0
9083,24,7,10,9,5,6,15,40.0,9,16,3,13,12,36,7,0
9084,56,39,38,16,2,28,52,53.8,24,30,10,20,29,85,67,0
9085,16,9,7,7,2,6,13,46.2,7,12,1,11,8,24,15,0
9086,11,6,6,5,0,4,5,80.0,1,5,4,1,23,34,29,0
9087,28,16,12,15,1,15,28,53.6,13,7,1,6,17,45,16,0
9088,9,7,4,4,1,3,11,27.3,8,6,1,5,6,15,7,0
9089,6,1,1,3,2,3,9,33.3,6,7,0,7,6,12,2,0
9090,35,27,18,8,9,19,35,54.3,16,20,1,19,22,57,37,0
9091,54,37,27,20,7,26,57,45.6,31,29,4,25,19,73,18,0
9092,2,1,2,0,0,1,2,50.0,1,2,2,0,3,5,2,0
9093,1,1,1,0,0,0,0,0.0,0,1,0,1,0,1,0,0
9094,31,22,21,10,0,15,22,68.2,7,11,5,6,14,45,20,0
9095,1,1,0,1,0,0,3,0.0,3,1,0,1,0,1,2,0
9096,37,26,13,16,8,13,38,34.2,25,28,2,26,13,50,23,2
9097,20,11,4,13,3,9,20,45.0,11,10,1,9,5,25,8,0
9098,27,20,11,15,1,13,33,39.4,20,21,3,18,16,43,18,0
9099,20,13,8,9,3,13,18,72.2,5,14,8,6,9,29,37,0
9100,55,31,22,31,2,33,70,47.1,37,26,7,19,29,84,37,0
9101,50,28,28,21,1,19,42,45.2,23,54,30,24,39,89,162,0
9102,7,6,1,4,2,5,8,62.5,3,5,0,5,5,12,2,0
9103,4,2,1,3,0,3,3,100.0,0,0,0,0,0,4,0,0
9104,0,0,0,0,0,0,0,0.0,0,0,0,0,1,1,5,2
9105,24,15,11,10,3,11,37,29.7,26,23,1,22,7,31,10,1
9106,2,1,2,0,0,0,4,0.0,4,3,0,3,1,3,3,0
9107,64,41,38,23,3,32,51,62.7,19,47,10,37,35,99,80,0
9108,8,5,3,5,0,4,15,26.7,11,2,0,2,5,13,13,0
9109,10,8,7,3,0,6,14,42.9,8,11,3,8,7,17,21,0
9110,40,28,15,19,6,23,52,44.2,29,11,2,9,11,51,8,1
9111,36,19,25,9,2,21,33,63.6,12,31,10,21,27,63,56,0
9112,0,0,0,0,0,0,1,0.0,1,0,0,0,0,0,0,0
9113,3,0,2,1,0,2,3,66.7,1,1,1,0,0,3,2,0
9114,0,0,0,0,0,0,0,0.0,0,0,0,0,0,0,0,0
9115,1,1,0,1,0,1,3,33.3,2,0,0,0,0,1,0,0
9116,0,0,0,0,0,0,0,0.0,0,0,0,0,1,1,0,0
9117,0,0,0,0,0,0,0,0.0,0,0,0,0,0,0,0,0
9118,3,2,0,3,0,2,4,50.0,2,3,1,2,0,3,0,0
9119,18,11,11,4,3,10,19,52.6,9,12,0,12,7,25,12,0
9120,2,2,1,1,0,2,2,100.0,0,0,0,0,2,4,2,0
9121,21,8,11,7,3,7,19,36.8,12,15,4,11,10,31,11,1
9122,2,2,1,0,1,1,1,100.0,0,0,0,0,0,2,0,0
9123,0,0,0,0,0,0,1,0.0,1,1,0,1,2,2,27,4
9124,0,0,0,0,0,0,1,0.0,1,2,2,0,1,1,4,0
9125,0,0,0,0,0,0,0,0.0,0,0,0,0,0,0,0,0
9126,14,8,4,6,4,8,12,66.7,4,4,0,4,3,17,3,0
9127,0,0,0,0,0,0,0,0.0,0,1,0,1,0,0,0,0
9128,26,16,21,5,0,19,30,63.3,11,17,8,9,27,53,94,1
9129,27,15,22,4,1,21,33,63.6,12,31,24,7,22,49,84,2
9130,0,0,0,0,0,0,0,0.0,0,0,0,0,0,0,3,0
9131,26,17,16,7,3,10,27,37.0,17,13,0,13,5,31,4,0
9132,49,28,24,22,3,30,42,71.4,12,23,10,13,24,73,38,1
9133,0,0,0,0,0,0,0,0.0,0,0,0,0,0,0,1,0
9134,5,2,5,0,0,5,10,50.0,5,16,10,6,14,19,52,0
9135,69,49,33,25,11,37,68,54.4,31,31,11,20,44,113,99,0
9136,7,3,4,3,0,5,9,55.6,4,0,0,0,7,14,2,0
9137,36,22,22,11,3,27,47,57.4,20,37,14,23,26,62,86,0
9138,14,9,12,2,0,8,13,61.5,5,6,2,4,7,21,12,0
9139,18,9,10,7,1,13,20,65.0,7,8,1,7,27,45,31,0
9140,3,1,2,1,0,1,2,50.0,1,2,0,2,2,5,5,0
9141,32,21,18,12,2,20,41,48.8,21,35,4,31,16,48,19,0
9142,40,29,21,12,7,18,47,38.3,29,15,0,15,15,55,21,0
9143,5,3,1,3,1,2,6,33.3,4,4,1,3,3,8,0,0
9144,1,1,0,1,0,1,1,100.0,0,1,0,1,2,3,0,0
9145,16,9,4,8,4,9,23,39.1,14,5,2,3,4,20,1,0
9146,39,27,24,14,1,24,40,60.0,16,50,38,12,26,65,119,3
9147,10,9,6,3,1,4,10,40.0,6,16,10,6,26,36,50,0
9148,0,0,0,0,0,0,1,0.0,1,0,0,0,0,0,8,0
9149,8,5,4,1,3,1,9,11.1,8,4,1,3,2,10,2,0
9150,17,10,1,10,6,9,14,64.3,5,9,0,9,2,19,1,0
9151,0,0,0,0,0,0,0,0.0,0,0,0,0,0,0,1,0
9152,36,18,10,14,12,13,37,35.1,24,30,6,24,14,50,25,0
9153,72,49,18,36,18,31,68,45.6,37,36,2,34,21,93,4,0
9154,15,9,5,6,4,5,14,35.7,9,2,0,2,2,17,4,1
9155,21,15,15,6,0,13,19,68.4,6,24,15,9,28,49,122,0
9156,0,0,0,0,0,0,0,0.0,0,1,0,1,0,0,1,0
9157,13,7,8,1,4,6,16,37.5,10,5,3,2,2,15,1,0
9158,7,5,5,0,2,3,6,50.0,3,1,0,1,2,9,6,0
9159,12,7,4,4,4,4,12,33.3,8,12,0,12,4,16,1,0
9160,38,25,28,7,3,18,24,75.0,6,31,17,14,28,66,125,2
9161,11,6,4,7,0,5,14,35.7,9,7,2,5,5,16,8,0
9162,3,3,0,1,2,2,2,100.0,0,1,0,1,0,3,1,0
9163,5,3,3,2,0,4,12,33.3,8,7,0,7,5,10,2,0
9164,42,24,28,11,3,17,24,70.8,7,53,31,22,48,90,138,2
9165,20,17,14,6,0,14,23,60.9,9,12,3,9,19,39,53,1
9166,0,0,0,0,0,0,0,0.0,0,0,0,0,1,1,10,0
9167,8,5,0,5,3,0,1,0.0,1,5,0,5,2,10,3,0
9168,20,10,15,4,1,12,20,60.0,8,17,3,14,9,29,33,0
9169,14,9,12,2,0,10,20,50.0,10,28,25,3,24,38,105,2
9170,12,7,5,2,5,6,20,30.0,14,11,3,8,4,16,7,1
9171,0,0,0,0,0,0,1,0.0,1,0,0,0,0,0,0,0
9172,6,2,2,0,4,2,5,40.0,3,3,0,3,1,7,0,0
9173,40,25,23,16,1,20,36,55.6,16,42,26,16,44,84,134,3
9174,6,3,2,3,1,1,7,14.3,6,11,1,10,0,6,6,0
9175,9,4,3,5,1,4,13,30.8,9,12,1,11,1,10,19,0
9176,12,8,9,3,0,8,20,40.0,12,22,12,10,16,28,54,0
9177,46,30,25,19,2,15,39,38.5,24,38,22,16,40,86,147,2
9178,56,32,35,21,0,18,35,51.4,17,61,42,19,75,131,228,1
9179,33,21,18,8,7,17,28,60.7,11,26,5,21,21,54,40,0
9180,0,0,0,0,0,0,0,0.0,0,0,0,0,0,0,2,0
9181,37,25,21,14,2,18,43,41.9,25,21,4,17,3,40,29,0
9182,12,7,8,3,1,5,6,83.3,1,26,19,7,21,33,104,0
9183,1,1,1,0,0,1,1,100.0,0,1,0,1,0,1,6,0
9184,67,33,27,34,6,37,76,48.7,39,23,4,19,29,96,47,0
9185,36,19,12,17,7,7,19,36.8,12,21,4,17,20,56,23,0
9186,1,1,0,0,1,1,1,100.0,0,1,0,1,0,1,0,0
9187,47,26,33,13,1,21,29,72.4,8,22,11,11,37,84,51,0
9188,2,0,0,0,2,1,2,50.0,1,2,0,2,2,4,4,0
9189,19,12,5,11,3,9,26,34.6,17,17,0,17,10,29,7,0
9190,53,38,19,26,8,29,61,47.5,32,28,3,25,20,73,5,0
9191,16,11,3,6,7,6,25,24.0,19,12,2,10,15,31,11,0
9192,46,34,29,13,4,24,47,51.1,23,23,3,20,26,72,57,0
9193,20,15,2,7,11,6,28,21.4,22,28,0,28,12,32,4,0
9194,11,5,5,4,2,7,12,58.3,5,11,3,8,3,14,16,0
9195,11,8,5,4,2,6,27,22.2,21,21,1,20,7,18,20,0
9196,4,2,1,2,1,2,2,100.0,0,1,1,0,2,6,1,0
9197,47,30,25,20,2,28,57,49.1,29,42,15,27,47,94,71,0
9198,4,3,2,2,0,1,8,12.5,7,1,0,1,6,10,3,0
9199,42,29,27,14,1,18,29,62.1,11,24,15,9,51,93,138,0
9200,9,5,6,2,1,4,8,50.0,4,4,0,4,2,11,4,0
9201,1,0,1,0,0,1,1,100.0,0,0,0,0,0,1,5,0
9202,3,3,0,2,1,2,5,40.0,3,1,0,1,0,3,2,0
9203,8,5,7,1,0,8,17,47.1,9,2,1,1,5,13,4,0
9204,95,69,52,33,10,55,83,66.3,28,36,14,22,48,143,158,1
9205,2,1,0,2,0,0,2,0.0,2,0,0,0,0,2,0,0
9206,45,30,29,13,3,22,34,64.7,12,38,7,31,45,90,66,1
9207,23,12,13,6,4,13,28,46.4,15,12,1,11,10,33,9,0
9208,49,38,25,17,7,24,41,58.5,17,31,1,30,27,76,46,0
9209,17,13,5,11,1,6,12,50.0,6,11,4,7,9,26,9,0
9210,2,0,1,1,0,0,2,0.0,2,1,0,1,0,2,2,0
9211,41,31,35,6,0,27,44,61.4,17,39,30,9,37,78,160,0
9212,32,28,18,10,4,16,40,40.0,24,13,3,10,21,53,33,0
9213,31,17,16,14,1,17,37,45.9,20,13,3,10,16,47,32,0
9214,28,20,11,12,5,13,33,39.4,20,31,3,28,14,42,24,1
9215,0,0,0,0,0,0,0,0.0,0,0,0,0,0,0,1,0
9216,23,13,3,15,5,6,20,30.0,14,17,0,17,9,32,19,0
9217,10,5,3,6,1,8,22,36.4,14,12,4,8,4,14,8,1
9218,2,2,2,0,0,1,3,33.3,2,1,1,0,1,3,3,0
9219,89,64,48,31,10,37,61,60.7,24,39,7,32,51,140,68,1
9220,36,24,23,10,3,15,26,57.7,11,26,19,7,25,61,99,0
9221,8,4,2,1,5,4,11,36.4,7,10,5,5,4,12,16,0
9222,10,9,5,2,3,2,13,15.4,11,6,0,6,4,14,7,0
9223,16,10,10,6,0,7,12,58.3,5,15,13,2,15,31,37,1
9224,10,7,1,6,3,5,10,50.0,5,12,0,12,2,12,9,0
9225,9,6,5,4,0,3,7,42.9,4,5,0,5,4,13,8,0
9226,14,6,5,4,5,9,13,69.2,4,5,0,5,8,22,3,0
9227,0,0,0,0,0,0,0,0.0,0,0,0,0,0,0,25,1
9228,55,39,34,15,6,34,59,57.6,25,38,9,29,23,78,67,0
9229,1,0,0,0,1,0,0,0.0,0,3,0,3,0,1,0,0
9230,0,0,0,0,0,0,0,0.0,0,0,0,0,0,0,0,0
9231,3,1,3,0,0,2,3,66.7,1,0,0,0,0,3,1,0
9232,26,16,10,12,4,19,32,59.4,13,18,3,15,7,33,26,0
9233,0,0,0,0,0,0,0,0.0,0,0,0,0,0,0,0,0
9234,25,17,6,13,6,12,27,44.4,15,20,1,19,7,32,34,0
9235,0,0,0,0,0,0,0,0.0,0,0,0,0,0,0,0,0
9236,10,5,8,1,1,7,11,63.6,4,9,2,7,7,17,22,1
9237,10,6,7,3,0,4,10,40.0,6,10,1,9,8,18,29,0
9238,30,21,17,7,6,16,25,64.0,9,31,5,26,16,46,32,0
9239,1,1,1,0,0,1,5,20.0,4,4,0,4,3,4,2,0
9240,27,20,17,10,0,17,26,65.4,9,8,2,6,17,44,45,0
9241,3,2,1,2,0,2,5,40.0,3,1,1,0,0,3,0,0
9242,2,1,2,0,0,1,2,50.0,1,0,0,0,0,2,8,0
9243,5,5,1,4,0,2,5,40.0,3,6,1,5,1,6,7,0
9244,9,5,3,3,3,4,8,50.0,4,7,0,7,6,15,0,0
9245,25,17,7,12,6,10,21,47.6,11,8,0,8,8,33,9,2
9246,3,2,3,0,0,2,3,66.7,1,2,0,2,1,4,3,0
9247,1,1,0,0,1,0,0,0.0,0,0,0,0,1,2,0,0
9248,64,41,41,19,4,39,60,65.0,21,31,8,23,79,143,55,0
9249,16,11,12,4,0,8,11,72.7,3,23,18,5,31,47,106,3
9250,9,5,3,6,0,7,13,53.8,6,0,0,0,4,13,2,0
9251,42,25,13,18,11,21,37,56.8,16,26,1,25,23,65,41,0
9252,4,2,2,1,1,3,8,37.5,5,5,0,5,1,5,2,0
9253,51,29,37,12,2,29,39,74.4,10,23,14,9,44,95,93,1
9254,59,33,31,24,4,28,52,53.8,24,24,5,19,41,100,61,0
9255,54,28,16,27,11,24,53,45.3,29,49,8,41,17,71,37,0
9256,1,0,1,0,0,0,1,0.0,1,2,0,2,1,2,2,0
9257,13,8,5,5,3,5,8,62.5,3,10,0,10,2,15,5,0
9258,2,0,0,2,0,0,1,0.0,1,2,0,2,2,4,4,0
9259,0,0,0,0,0,0,0,0.0,0,1,0,1,0,0,0,0
9260,25,16,12,11,2,11,14,78.6,3,9,9,0,12,37,57,0
9261,28,20,7,15,6,11,18,61.1,7,11,2,9,3,31,13,1
9262,46,28,15,22,9,19,73,26.0,54,41,1,40,16,62,23,0
9263,0,0,0,0,0,0,0,0.0,0,1,0,1,0,0,0,0
9264,15,8,11,4,0,8,15,53.3,7,15,5,10,8,23,25,1
9265,1,0,1,0,0,1,1,100.0,0,0,0,0,0,1,3,1
9266,1,0,1,0,0,0,1,0.0,1,1,0,1,0,1,0,0
9267,0,0,0,0,0,0,0,0.0,0,0,0,0,0,0,3,0
9268,37,30,25,8,4,19,47,40.4,28,29,7,22,18,55,29,0
9269,1,1,0,1,0,0,0,0.0,0,1,0,1,1,2,0,0
9270,17,12,11,2,4,7,14,50.0,7,11,0,11,3,20,6,0
9271,19,12,5,10,4,9,28,32.1,19,17,2,15,1,20,31,0
9272,1,0,1,0,0,0,0,0.0,0,0,0,0,1,2,0,0
9273,9,7,2,2,5,3,7,42.9,4,6,1,5,4,13,11,0
9274,27,19,10,12,5,14,33,42.4,19,20,1,19,16,43,13,0
9275,63,41,46,16,1,39,46,84.8,7,52,28,24,56,119,146,1
9276,4,2,1,2,1,3,7,42.9,4,7,1,6,2,6,0,0
9277,19,10,13,5,1,16,17,94.1,1,9,2,7,11,30,38,0
9278,6,4,3,2,1,3,7,42.9,4,8,1,7,1,7,0,0
9279,1,0,0,0,1,0,0,0.0,0,3,1,2,1,2,0,0
9280,41,24,16,19,6,23,52,44.2,29,30,7,23,14,55,26,0
9281,47,32,33,12,2,28,48,58.3,20,32,12,20,32,79,72,0
9282,6,6,2,2,2,1,6,16.7,5,6,0,6,3,9,8,0
9283,5,2,2,2,1,0,1,0.0,1,2,0,2,1,6,6,0
9284,40,25,21,17,2,18,38,47.4,20,41,22,19,41,81,76,1
9285,41,25,23,15,3,32,51,62.7,19,23,7,16,11,52,40,0
9286,17,12,3,7,7,11,13,84.6,2,6,0,6,4,21,5,0
9287,10,7,1,7,2,2,7,28.6,5,3,1,2,4,14,3,0
9288,32,13,10,19,3,14,28,50.0,14,21,4,17,7,39,9,0
9289,5,3,1,4,0,1,1,100.0,0,3,2,1,5,10,9,0
9290,55,41,29,20,6,28,81,34.6,53,38,7,31,27,82,23,0
9291,0,0,0,0,0,0,0,0.0,0,1,0,1,0,0,0,0
9292,28,18,20,4,4,20,27,74.1,7,23,10,13,30,58,43,1
9293,16,12,5,9,2,4,19,21.1,15,12,0,12,4,20,2,0
9294,42,23,19,20,3,22,44,50.0,22,20,7,13,48,90,58,1
9295,0,0,0,0,0,0,1,0.0,1,2,0,2,1,1,17,6
9296,7,3,1,3,3,4,6,66.7,2,4,2,2,3,10,5,0
9297,38,24,17,16,5,15,34,44.1,19,13,1,12,2,40,4,0
9298,35,19,14,18,3,15,36,41.7,21,30,3,27,11,46,17,0
9299,15,10,5,10,0,7,15,46.7,8,6,0,6,4,19,3,0
9300,0,0,0,0,0,0,0,0.0,0,0,0,0,0,0,0,0
9301,32,24,7,15,10,19,52,36.5,33,35,4,31,8,40,8,0
9302,1,1,0,1,0,0,0,0.0,0,1,1,0,1,2,1,0
9303,41,27,25,15,1,27,56,48.2,29,29,6,23,20,61,56,1
9304,4,4,2,1,1,0,7,0.0,7,5,0,5,1,5,3,0
9305,42,34,20,14,8,23,39,59.0,16,33,5,28,44,86,49,1
9306,2,1,0,0,2,0,0,0.0,0,0,0,0,0,2,5,0
9307,4,1,1,1,2,0,2,0.0,2,4,0,4,0,4,1,0
9308,54,35,40,14,0,37,54,68.5,17,54,31,23,30,84,134,1
9309,7,4,1,4,2,5,11,45.5,6,5,0,5,3,10,2,0
9310,24,12,13,11,0,16,21,76.2,5,27,21,6,20,44,70,0
9311,49,27,14,27,8,21,46,45.7,25,26,5,21,16,65,11,0
9312,22,14,6,10,6,5,7,71.4,2,7,0,7,6,28,3,0
9313,85,56,56,24,5,37,67,55.2,30,36,2,34,24,109,57,0
9314,19,12,9,7,3,11,14,78.6,3,10,4,6,10,29,15,0
9315,26,16,17,7,2,17,20,85.0,3,27,24,3,13,39,79,1
9316,9,3,2,3,4,2,6,33.3,4,11,1,10,1,10,1,0
9317,19,11,7,9,3,9,24,37.5,15,31,2,29,4,23,6,0
9318,1,0,1,0,0,0,0,0.0,0,0,0,0,1,2,7,0
9319,18,13,9,7,2,9,15,60.0,6,16,9,7,24,42,43,1
9320,0,0,0,0,0,0,0,0.0,0,0,0,0,0,0,0,0
9321,12,9,6,4,2,5,19,26.3,14,14,1,13,14,26,11,0
9322,12,10,10,2,0,8,22,36.4,14,7,2,5,10,22,11,0
9323,36,27,20,12,4,10,21,47.6,11,14,0,14,14,50,8,1
9324,35,20,22,11,2,23,39,59.0,16,20,3,17,50,85,63,0
9325,33,21,10,21,2,23,42,54.8,19,14,2,12,29,62,5,0
9326,0,0,0,0,0,0,0,0.0,0,0,0,0,0,0,0,0
9327,9,4,4,1,4,1,5,20.0,4,10,3,7,0,9,3,0
9328,5,3,2,2,1,3,5,60.0,2,1,0,1,0,5,2,0
9329,27,13,15,8,4,19,35,54.3,16,15,4,11,22,49,34,0
9330,15,10,8,6,1,9,16,56.3,7,14,2,12,13,28,20,0
9331,16,9,6,9,1,9,16,56.3,7,18,5,13,6,22,14,0
9332,9,4,7,2,0,4,9,44.4,5,2,0,2,3,12,7,0
9333,3,1,0,2,1,2,6,33.3,4,4,1,3,0,3,9,0
9334,1,1,0,1,0,0,1,0.0,1,2,0,2,0,1,4,0
9335,24,15,7,11,6,5,15,33.3,10,28,4,24,10,34,14,0
9336,4,3,1,1,2,2,3,66.7,1,2,1,1,0,4,1,0
9337,26,12,15,8,3,17,26,65.4,9,22,5,17,9,35,54,0
9338,20,11,17,2,1,11,17,64.7,6,34,24,10,15,35,97,0
9339,13,4,5,4,4,7,14,50.0,7,17,3,14,3,16,15,1
9340,0,0,0,0,0,0,0,0.0,0,1,0,1,0,0,0,0
9341,1,0,0,1,0,1,1,100.0,0,0,0,0,0,1,0,0
9342,21,12,10,7,4,6,27,22.2,21,28,2,26,8,29,12,0
9343,28,18,16,10,2,14,24,58.3,10,24,12,12,32,60,114,0
9344,27,19,16,9,2,20,44,45.5,24,25,7,18,22,49,62,0
9345,5,4,0,2,3,2,9,22.2,7,9,1,8,4,9,1,0
9346,9,6,2,7,0,3,3,100.0,0,2,0,2,2,11,1,0
9347,4,1,2,2,0,2,3,66.7,1,0,0,0,2,6,8,0
9348,0,0,0,0,0,0,0,0.0,0,1,1,0,1,1,0,0
9349,46,29,27,17,2,30,51,58.8,21,24,10,14,19,65,33,0
9350,0,0,0,0,0,0,0,0.0,0,0,0,0,0,0,17,5
9351,15,8,5,6,4,8,20,40.0,12,4,0,4,4,19,5,0
9352,18,12,15,3,0,13,24,54.2,11,14,4,10,12,30,18,0
9353,10,4,4,6,0,6,11,54.5,5,2,1,1,1,11,3,0
9354,15,5,5,7,3,7,10,70.0,3,11,3,8,8,23,25,0
9355,25,11,14,8,3,13,18,72.2,5,22,9,13,31,56,56,0
9356,43,20,28,15,0,25,39,64.1,14,33,20,13,34,77,135,0
9357,22,13,8,9,5,7,11,63.6,4,12,1,11,8,30,6,0
9358,0,0,0,0,0,0,0,0.0,0,0,0,0,0,0,0,0
9359,4,2,0,3,1,1,3,33.3,2,1,0,1,2,6,3,0
9360,24,17,15,6,3,10,17,58.8,7,11,3,8,8,32,26,0
9361,55,34,25,24,6,25,41,61.0,16,48,14,34,31,86,33,1
9362,1,1,0,1,0,0,0,0.0,0,0,0,0,0,1,0,0
9363,20,9,5,13,2,16,44,36.4,28,23,1,22,13,33,21,0
9364,19,15,11,6,2,9,18,50.0,9,17,6,11,10,29,52,0
9365,0,0,0,0,0,0,1,0.0,1,0,0,0,0,0,9,2
9366,0,0,0,0,0,0,0,0.0,0,0,0,0,0,0,4,1
9367,0,0,0,0,0,0,1,0.0,1,0,0,0,0,0,0,0
9368,4,3,2,2,0,2,10,20.0,8,2,1,1,6,10,2,0
9369,4,3,2,0,2,3,8,37.5,5,3,1,2,2,6,8,0
9370,13,11,1,10,2,7,14,50.0,7,25,4,21,2,15,16,0
9371,8,5,4,3,1,4,10,40.0,6,3,0,3,1,9,0,0
9372,58,34,24,25,9,28,69,40.6,41,23,0,23,21,79,15,1
9373,9,4,2,4,3,6,14,42.9,8,5,1,4,3,12,15,0
9374,70,39,42,27,1,23,35,65.7,12,37,21,16,38,108,117,3
9375,42,33,17,14,11,19,48,39.6,29,54,3,51,18,60,16,0
9376,12,4,1,6,5,5,11,45.5,6,10,1,9,4,16,10,0
9377,47,27,15,22,10,24,65,36.9,41,22,1,21,16,63,9,0
9378,3,2,2,0,1,1,1,100.0,0,1,0,1,0,3,0,0
9379,18,10,6,9,3,10,19,52.6,9,7,0,7,5,23,7,0
9380,13,12,5,5,3,9,17,52.9,8,15,0,15,6,19,3,0
9381,20,14,6,10,4,10,32,31.3,22,13,1,12,11,31,2,0
9382,25,12,19,6,0,10,19,52.6,9,20,9,11,20,45,37,0
9383,44,31,21,19,4,22,29,75.9,7,31,18,13,37,81,125,0
9384,32,20,15,10,7,14,31,45.2,17,24,0,24,10,42,16,0
9385,1,1,1,0,0,1,2,50.0,1,0,0,0,1,2,0,0
9386,4,0,1,1,2,0,2,0.0,2,3,0,3,0,4,0,0
9387,2,2,0,1,1,0,3,0.0,3,7,1,6,1,3,6,0
9388,2,1,0,1,1,1,2,50.0,1,2,0,2,0,2,1,0
9389,2,1,1,1,0,1,3,33.3,2,1,0,1,1,3,2,0
9390,0,0,0,0,0,0,0,0.0,0,1,0,1,0,0,0,0
9391,0,0,0,0,0,0,0,0.0,0,1,0,1,1,1,2,0
9392,31,21,8,15,8,10,22,45.5,12,22,5,17,14,45,20,0
9393,3,2,3,0,0,2,2,100.0,0,2,1,1,1,4,1,0
9394,18,9,7,8,3,11,20,55.0,9,11,2,9,7,25,7,0
9395,27,16,20,5,2,22,36,61.1,14,31,19,12,39,66,102,1
9396,11,8,7,4,0,9,14,64.3,5,6,0,6,8,19,19,0
9397,1,1,1,0,0,0,0,0.0,0,1,0,1,1,2,7,0
9398,16,8,5,8,3,8,12,66.7,4,4,1,3,4,20,5,0
9399,0,0,0,0,0,0,0,0.0,0,0,0,0,0,0,0,0
9400,13,10,6,7,0,5,10,50.0,5,6,2,4,3,16,32,0
9401,1,1,0,1,0,0,0,0.0,0,0,0,0,0,1,0,0
9402,23,13,13,10,0,9,15,60.0,6,21,15,6,17,40,39,1
9403,0,0,0,0,0,0,1,0.0,1,0,0,0,1,1,15,7
9404,7,4,4,3,0,1,4,25.0,3,12,8,4,17,24,39,0
9405,4,2,1,2,1,1,4,25.0,3,6,2,4,1,5,3,0
9406,29,20,12,13,4,13,35,37.1,22,28,3,25,18,47,30,1
9407,0,0,0,0,0,0,0,0.0,0,0,0,0,0,0,1,0
9408,45,19,22,15,8,18,47,38.3,29,30,5,25,49,94,22,0
9409,25,11,20,5,0,18,24,75.0,6,32,22,10,24,49,122,1
9410,1,1,1,0,0,0,1,0.0,1,0,0,0,0,1,0,0
9411,0,0,0,0,0,0,0,0.0,0,0,0,0,0,0,0,0
9412,35,16,23,10,2,19,32,59.4,13,13,2,11,14,49,33,0
9413,76,38,29,40,7,35,61,57.4,26,42,3,39,41,117,18,1
9414,2,1,1,1,0,1,2,50.0,1,2,1,1,0,2,9,0
9415,0,0,0,0,0,0,1,0.0,1,1,0,1,1,1,0,0
9416,0,0,0,0,0,0,1,0.0,1,0,0,0,0,0,0,0
9417,12,4,8,3,1,7,10,70.0,3,2,1,1,6,18,4,0
9418,7,6,3,4,0,3,6,50.0,3,6,2,4,4,11,3,0
9419,0,0,0,0,0,0,0,0.0,0,5,0,5,1,1,2,0
9420,0,0,0,0,0,0,0,0.0,0,1,0,1,1,1,4,0
9421,53,32,20,26,7,30,61,49.2,31,26,4,22,18,71,16,0
9422,5,4,4,1,0,2,7,28.6,5,3,1,2,2,7,1,0
9423,13,9,6,5,2,6,13,46.2,7,15,2,13,6,19,17,0
9424,1,1,1,0,0,0,0,0.0,0,0,0,0,0,1,0,0
9425,9,6,2,3,4,3,7,42.9,4,9,1,8,1,10,3,0
9426,15,8,7,8,0,4,15,26.7,11,7,4,3,12,27,6,1
9427,2,2,1,1,0,2,3,66.7,1,1,1,0,0,2,2,0
9428,59,36,16,31,12,34,72,47.2,38,15,1,14,8,67,4,0
9429,0,0,0,0,0,0,0,0.0,0,0,0,0,0,0,0,0
9430,16,13,4,8,4,3,6,50.0,3,11,0,11,2,18,0,0
9431,50,41,35,13,2,36,52,69.2,16,26,6,20,21,71,77,0
9432,0,0,0,0,0,0,0,0.0,0,0,0,0,0,0,0,0
9433,61,43,26,30,5,20,39,51.3,19,49,10,39,36,97,41,0
9434,7,3,4,3,0,3,8,37.5,5,0,0,0,2,9,4,0
9435,4,0,0,4,0,3,4,75.0,1,3,1,2,2,6,0,0
9436,6,3,1,5,0,1,2,50.0,1,1,0,1,1,7,1,0
9437,13,6,4,5,4,2,4,50.0,2,11,1,10,4,17,12,0
9438,7,4,3,4,0,3,4,75.0,1,3,3,0,13,20,36,0
9439,5,3,5,0,0,4,6,66.7,2,6,3,3,3,8,23,0
9440,1,0,1,0,0,1,1,100.0,0,1,0,1,1,2,15,4
9441,8,1,4,3,1,2,6,33.3,4,7,0,7,3,11,2,0
9442,55,34,33,20,2,31,53,58.5,22,28,13,15,34,89,66,0
9443,1,1,1,0,0,0,0,0.0,0,1,0,1,2,3,0,0
9444,0,0,0,0,0,0,0,0.0,0,0,0,0,0,0,16,1
9445,36,22,14,17,5,16,36,44.4,20,18,3,15,17,53,12,0
9446,87,62,32,45,10,38,87,43.7,49,34,1,33,55,142,45,0
9447,44,21,27,16,1,20,46,43.5,26,36,23,13,29,73,90,2
9448,66,43,25,35,6,36,57,63.2,21,31,15,16,48,114,74,2
9449,25,16,11,7,7,8,25,32.0,17,25,4,21,10,35,16,1
9450,28,13,13,11,4,13,22,59.1,9,24,14,10,73,101,70,0
9451,12,8,3,7,2,8,14,57.1,6,4,1,3,7,19,11,0
9452,0,0,0,0,0,0,0,0.0,0,0,0,0,0,0,2,0
9453,42,27,18,18,6,16,31,51.6,15,17,1,16,12,54,15,0
9454,16,13,12,4,0,9,12,75.0,3,18,12,6,13,29,75,1
9455,1,1,1,0,0,0,0,0.0,0,1,0,1,0,1,0,0
9456,84,53,37,37,10,30,87,34.5,57,44,8,36,49,133,38,1
9457,1,1,0,1,0,1,1,100.0,0,4,2,2,1,2,5,0
9458,26,15,13,12,1,8,26,30.8,18,13,2,11,23,49,27,2
9459,34,21,13,15,6,13,37,35.1,24,14,0,14,16,50,15,1
9460,56,35,36,17,3,29,58,50.0,29,26,7,19,20,76,39,0
9461,90,57,60,26,4,48,72,66.7,24,51,16,35,35,125,75,0
9462,3,2,2,1,0,1,8,12.5,7,8,0,8,3,6,2,0
9463,6,4,2,3,1,2,6,33.3,4,14,11,3,5,11,53,0
9464,26,18,12,13,1,10,32,31.3,22,15,3,12,21,47,23,1
9465,42,26,31,10,1,27,50,54.0,23,26,11,15,45,87,55,0
9466,0,0,0,0,0,0,0,0.0,0,0,0,0,0,0,0,0
9467,0,0,0,0,0,0,0,0.0,0,0,0,0,0,0,0,0
9468,2,1,0,2,0,1,1,100.0,0,1,0,1,0,2,0,0
9469,0,0,0,0,0,0,0,0.0,0,0,0,0,0,0,0,0
9470,54,28,20,20,14,20,67,29.9,47,48,3,45,15,69,7,0
9471,30,17,11,10,9,16,37,43.2,21,23,2,21,8,38,9,0
9472,32,14,15,11,6,12,35,34.3,23,23,1,22,13,45,7,0
9473,46,30,37,7,2,23,31,74.2,8,44,23,21,33,79,122,1
9474,7,3,1,6,0,2,4,50.0,2,7,2,5,2,9,3,0
9475,48,28,26,17,5,19,43,44.2,24,31,10,21,32,80,51,0
9476,18,11,8,7,3,5,17,29.4,12,13,3,10,6,24,14,1
9477,2,2,0,1,1,1,1,100.0,0,2,0,2,0,2,1,0
9478,28,22,18,9,1,14,20,70.0,6,23,7,16,25,53,77,0
9479,0,0,0,0,0,0,0,0.0,0,2,1,1,0,0,1,0
9480,1,0,1,0,0,1,1,100.0,0,0,0,0,0,1,1,0
9481,1,1,0,1,0,0,3,0.0,3,2,0,2,0,1,0,0
9482,9,5,3,5,1,2,6,33.3,4,3,2,1,0,9,5,0
9483,2,2,0,1,1,0,2,0.0,2,2,0,2,1,3,1,0
9484,33,22,17,13,3,13,23,56.5,10,16,6,10,12,45,46,0
9485,2,2,0,1,1,0,4,0.0,4,4,3,1,0,2,1,0
9486,53,30,29,22,2,28,39,71.8,11,23,9,14,30,83,56,1
9487,3,3,1,1,1,2,2,100.0,0,4,1,3,3,6,14,1
9488,22,14,18,4,0,14,20,70.0,6,22,9,13,12,34,110,2
9489,0,0,0,0,0,0,1,0.0,1,0,0,0,0,0,0,0
9490,13,7,5,6,2,5,13,38.5,8,9,3,6,6,19,9,0
9491,3,0,3,0,0,3,4,75.0,1,2,2,0,2,5,3,1
9492,6,3,1,3,2,1,3,33.3,2,3,0,3,0,6,1,0
9493,21,13,2,9,10,8,21,38.1,13,24,2,22,4,25,6,0
9494,1,1,0,1,0,1,1,100.0,0,1,0,1,2,3,4,0
9495,19,11,11,7,1,9,23,39.1,14,10,3,7,15,34,7,1
9496,29,16,15,14,0,15,22,68.2,7,11,7,4,28,57,58,0
9497,28,16,13,11,4,12,26,46.2,14,17,1,16,16,44,33,2
9498,24,16,8,12,4,8,32,25.0,24,20,0,20,7,31,2,2
9499,2,0,0,1,1,0,0,0.0,0,2,1,1,2,4,0,0
9500,1,0,1,0,0,0,1,0.0,1,3,0,3,1,2,0,0
9501,73,53,37,25,11,38,86,44.2,48,62,11,51,31,104,43,0
9502,3,3,0,3,0,1,2,50.0,1,0,0,0,3,6,0,0
9503,27,12,15,11,1,15,39,38.5,24,23,6,17,23,50,21,1
9504,26,20,7,11,8,8,20,40.0,12,28,2,26,7,33,16,0
9505,21,12,11,8,2,6,14,42.9,8,13,1,12,9,30,11,0
9506,36,14,11,23,2,15,42,35.7,27,23,3,20,19,55,15,1
9507,51,31,32,17,2,31,44,70.5,13,19,2,17,14,65,41,1
9508,2,2,0,1,1,2,4,50.0,2,2,1,1,0,2,2,0
9509,0,0,0,0,0,0,0,0.0,0,0,0,0,0,0,0,0
9510,0,0,0,0,0,0,0,0.0,0,0,0,0,0,0,23,1
9511,23,15,15,5,3,16,25,64.0,9,13,4,9,12,35,22,0
9512,62,46,31,29,2,26,48,54.2,22,30,18,12,62,124,61,1
9513,0,0,0,0,0,0,1,0.0,1,0,0,0,0,0,0,0
9514,47,25,32,13,2,25,44,56.8,19,31,20,11,36,83,123,0
9515,38,22,21,15,2,19,52,36.5,33,31,14,17,37,75,34,0
9516,26,18,15,10,1,7,28,25.0,21,10,0,10,11,37,29,0
9517,2,2,0,1,1,1,3,33.3,2,1,0,1,2,4,2,0
9518,21,12,16,5,0,14,25,56.0,11,7,0,7,10,31,20,1
9519,21,13,9,6,6,12,31,38.7,19,15,1,14,9,30,3,0
9520,52,31,34,14,4,31,42,73.8,11,45,25,20,48,100,119,1
9521,15,10,5,6,4,3,19,15.8,16,22,0,22,7,22,9,0
9522,42,28,22,20,0,25,56,44.6,31,23,3,20,15,57,8,2
9523,0,0,0,0,0,0,0,0.0,0,0,0,0,0,0,2,0
9524,40,22,23,14,3,24,41,58.5,17,13,7,6,23,63,42,0
9525,16,12,13,2,1,10,16,62.5,6,26,18,8,12,28,66,1
9526,0,0,0,0,0,0,0,0.0,0,1,0,1,0,0,1,0
9527,14,8,8,4,2,8,16,50.0,8,19,12,7,11,25,40,0
9528,27,15,10,13,4,12,26,46.2,14,20,4,16,5,32,27,1
9529,36,24,18,12,6,21,47,44.7,26,35,5,30,14,50,36,0
9530,17,11,9,7,1,5,19,26.3,14,16,2,14,3,20,6,0
9531,20,16,14,5,1,12,21,57.1,9,10,2,8,11,31,26,0
9532,11,10,4,5,2,10,18,55.6,8,13,2,11,4,15,19,0
9533,21,13,16,5,0,11,13,84.6,2,21,15,6,25,46,134,0
9534,2,1,1,1,0,0,1,0.0,1,0,0,0,0,2,0,0
9535,29,17,9,14,6,10,27,37.0,17,23,0,23,8,37,10,0
9536,7,5,1,4,2,2,11,18.2,9,8,2,6,1,8,16,0
9537,1,1,0,0,1,0,1,0.0,1,0,0,0,1,2,0,0
9538,0,0,0,0,0,0,0,0.0,0,0,0,0,0,0,0,0
9539,30,17,18,11,1,19,47,40.4,28,21,4,17,9,39,31,0
9540,31,22,15,14,2,15,21,71.4,6,24,12,12,19,50,73,1
9541,13,6,3,6,4,6,17,35.3,11,29,6,23,3,16,30,0
9542,0,0,0,0,0,0,0,0.0,0,1,1,0,1,1,0,0
9543,0,0,0,0,0,0,0,0.0,0,0,0,0,0,0,0,0
9544,0,0,0,0,0,0,1,0.0,1,2,0,2,0,0,3,0
9545,17,10,0,12,5,10,17,58.8,7,4,0,4,2,19,10,0
9546,0,0,0,0,0,0,0,0.0,0,2,1,1,0,0,4,0
9547,10,5,4,5,1,3,12,25.0,9,11,0,11,10,20,23,0
9548,1,1,1,0,0,1,1,100.0,0,1,0,1,0,1,6,5
9549,20,13,14,6,0,7,11,63.6,4,30,26,4,17,37,111,0
9550,3,2,2,0,1,1,2,50.0,1,3,0,3,2,5,0,0
9551,0,0,0,0,0,0,0,0.0,0,0,0,0,0,0,0,0
9552,22,12,10,3,9,8,26,30.8,18,11,0,11,6,28,9,0
9553,0,0,0,0,0,0,1,0.0,1,0,0,0,0,0,7,2
9554,2,2,0,2,0,0,0,0.0,0,1,0,1,0,2,3,0
9555,75,43,25,31,19,37,59,62.7,22,35,7,28,21,96,33,0
9556,12,8,2,4,6,3,6,50.0,3,8,1,7,2,14,8,0
9557,0,0,0,0,0,0,1,0.0,1,0,0,0,0,0,0,0
9558,25,13,15,7,3,10,16,62.5,6,10,7,3,13,38,38,1
9559,1,0,0,0,1,1,4,25.0,3,1,0,1,0,1,1,0
9560,22,16,7,11,4,11,28,39.3,17,9,1,8,10,32,9,0
9561,30,17,24,5,1,20,34,58.8,14,19,13,6,24,54,63,1
9562,98,71,46,45,7,61,113,54.0,52,50,2,48,68,166,66,0
9563,7,5,3,4,0,2,4,50.0,2,1,0,1,5,12,1,0
9564,65,37,41,17,7,37,80,46.3,43,41,7,34,26,91,47,0
9565,50,28,16,23,11,18,46,39.1,28,32,7,25,24,74,26,0
9566,3,3,1,1,1,0,0,0.0,0,0,0,0,0,3,0,0
9567,39,30,17,17,5,16,45,35.6,29,20,6,14,21,60,30,0
9568,36,22,22,10,4,15,41,36.6,26,35,2,33,17,53,25,0
9569,38,22,11,22,5,18,43,41.9,25,24,4,20,15,53,24,1
9570,38,27,13,14,11,18,36,50.0,18,25,0,25,3,41,15,0
9571,24,12,6,10,8,11,24,45.8,13,11,1,10,4,28,9,0
9572,3,0,1,1,1,1,3,33.3,2,1,0,1,1,4,0,0
9573,30,16,10,14,6,12,26,46.2,14,8,1,7,4,34,7,0
9574,37,27,16,15,6,18,49,36.7,31,26,7,19,28,65,15,0
9575,32,25,26,6,0,11,18,61.1,7,32,21,11,27,59,199,0
9576,56,40,21,34,1,28,53,52.8,25,25,10,15,23,79,42,0
9577,2,0,0,2,0,0,0,0.0,0,0,0,0,0,2,0,0
9578,25,13,23,2,0,15,27,55.6,12,33,26,7,34,59,127,2
9579,21,12,10,11,0,9,14,64.3,5,10,5,5,17,38,30,0
9580,64,34,22,37,5,31,80,38.8,49,39,2,37,40,104,16,0
9581,1,1,1,0,0,0,0,0.0,0,1,0,1,0,1,10,1
9582,8,4,1,3,4,5,11,45.5,6,15,5,10,11,19,25,0
9583,39,23,25,12,2,20,45,44.4,25,28,6,22,16,55,37,1
9584,64,35,23,34,7,34,62,54.8,28,28,5,23,29,93,11,0
9585,1,1,0,0,1,1,7,14.3,6,5,2,3,0,1,6,0
9586,56,40,34,20,2,35,65,53.8,30,22,2,20,10,66,23,1
9587,42,28,14,22,6,11,44,25.0,33,37,0,37,26,68,6,0
9588,1,1,1,0,0,1,5,20.0,4,1,0,1,1,2,9,2
9589,59,33,16,31,12,21,49,42.9,28,35,4,31,9,68,15,0
9590,36,24,10,18,8,22,51,43.1,29,28,4,24,15,51,25,0
9591,0,0,0,0,0,0,0,0.0,0,0,0,0,0,0,0,0
9592,109,75,57,39,13,59,84,70.2,25,53,10,43,61,170,110,1
9593,25,13,13,11,1,16,24,66.7,8,17,8,9,22,47,52,0
9594,38,23,24,10,4,29,45,64.4,16,20,3,17,18,56,46,0
9595,34,23,17,16,1,18,30,60.0,12,22,3,19,6,40,21,0
9596,20,13,10,6,4,10,27,37.0,17,19,7,12,27,47,59,0
9597,1,1,1,0,0,1,2,50.0,1,2,1,1,3,4,8,0
9598,30,24,8,22,0,16,28,57.1,12,17,2,15,21,51,3,0
9599,15,8,9,6,0,4,7,57.1,3,20,15,5,11,26,79,1
9600,56,37,30,24,2,26,38,68.4,12,51,25,26,32,88,142,1
9601,29,16,19,7,3,20,32,62.5,12,13,6,7,15,44,43,0
9602,10,4,7,2,1,5,14,35.7,9,8,5,3,18,28,33,0
9603,2,2,2,0,0,0,1,0.0,1,0,0,0,1,3,3,0
9604,6,4,2,4,0,1,5,20.0,4,4,0,4,5,11,1,1
9605,0,0,0,0,0,0,0,0.0,0,0,0,0,0,0,7,0
9606,6,5,2,2,2,2,3,66.7,1,5,0,5,1,7,7,0
9607,43,27,18,21,4,13,34,38.2,21,25,4,21,28,71,34,2
9608,38,21,16,20,2,23,36,63.9,13,29,5,24,14,52,37,1
9609,25,18,6,13,6,7,21,33.3,14,9,0,9,10,35,3,0
9610,58,30,22,28,8,32,60,53.3,28,45,10,35,36,94,38,0
9611,0,0,0,0,0,0,2,0.0,2,0,0,0,0,0,0,0
9612,37,24,17,15,5,18,33,54.5,15,23,16,7,54,91,142,0
9613,12,8,3,9,0,3,15,20.0,12,10,2,8,6,18,24,0
9614,65,37,23,36,6,23,76,30.3,53,40,4,36,47,112,49,0
9615,38,21,18,17,3,20,31,64.5,11,38,12,26,36,74,45,0
9616,5,4,3,1,1,4,5,80.0,1,3,0,3,1,6,1,0
9617,33,23,16,15,2,11,22,50.0,11,40,25,15,30,63,121,1
9618,15,8,4,10,1,3,9,33.3,6,10,1,9,5,20,22,1
9619,12,7,9,1,2,9,18,50.0,9,9,4,5,8,20,28,0
9620,22,13,9,10,3,8,20,40.0,12,25,2,23,8,30,7,0
9621,7,4,4,1,2,4,6,66.7,2,4,0,4,1,8,4,0
9622,16,8,11,4,1,6,8,75.0,2,20,14,6,24,40,126,1
9623,33,17,16,15,2,23,37,62.2,14,26,4,22,11,44,20,1
9624,11,8,9,1,1,6,8,75.0,2,10,5,5,6,17,54,1
9625,54,27,35,17,2,32,51,62.7,19,31,11,20,19,73,47,0
9626,2,1,0,1,1,1,4,25.0,3,3,1,2,1,3,5,0
9627,3,2,1,2,0,2,2,100.0,0,1,0,1,1,4,6,0
9628,14,11,4,8,2,2,6,33.3,4,5,0,5,0,14,2,0
9629,6,5,2,3,1,3,8,37.5,5,6,0,6,1,7,8,1
9630,15,8,14,1,0,7,8,87.5,1,12,9,3,19,34,53,0
9631,0,0,0,0,0,0,0,0.0,0,0,0,0,0,0,1,0
9632,95,63,32,56,7,45,78,57.7,33,27,2,25,32,127,36,0
9633,22,12,13,9,0,13,21,61.9,8,17,4,13,20,42,37,0
9634,0,0,0,0,0,0,0,0.0,0,0,0,0,0,0,1,0
9635,7,5,1,6,0,2,9,22.2,7,8,0,8,6,13,4,0
9636,0,0,0,0,0,0,1,0.0,1,4,0,4,0,0,3,0
9637,19,10,10,8,1,9,24,37.5,15,23,2,21,10,29,20,0
9638,11,8,3,8,0,2,4,50.0,2,3,3,0,8,19,20,0
9639,4,2,1,2,1,3,11,27.3,8,4,0,4,4,8,2,0
9640,4,1,2,2,0,1,1,100.0,0,0,0,0,3,7,1,0
9641,73,39,33,35,5,38,67,56.7,29,22,5,17,22,95,20,3
9642,48,34,33,13,2,24,39,61.5,15,35,18,17,44,92,103,1
9643,30,12,15,10,5,13,29,44.8,16,16,8,8,10,40,49,1
9644,13,12,10,3,0,8,11,72.7,3,6,4,2,19,32,8,1
9645,7,6,0,6,1,0,8,0.0,8,8,2,6,5,12,7,0
9646,2,1,1,0,1,2,5,40.0,3,5,0,5,0,2,0,0
9647,46,25,30,11,5,21,37,56.8,16,17,3,14,27,73,46,0
9648,2,1,2,0,0,2,3,66.7,1,1,0,1,0,2,5,4
9649,1,0,0,1,0,1,1,100.0,0,0,0,0,0,1,0,0
9650,10,6,3,6,1,5,11,45.5,6,7,0,7,8,18,15,1
9651,25,12,14,11,0,5,16,31.3,11,10,2,8,23,48,27,0
9652,15,12,8,6,1,11,14,78.6,3,9,6,3,18,33,37,0
9653,36,27,14,13,9,16,35,45.7,19,24,3,21,21,57,29,0
9654,6,3,1,5,0,1,10,10.0,9,14,4,10,2,8,41,0
9655,3,1,2,1,0,1,1,100.0,0,1,0,1,1,4,1,0
9656,58,33,32,18,8,33,63,52.4,30,31,5,26,24,82,45,1
9657,18,13,9,9,0,4,9,44.4,5,12,2,10,6,24,10,0
9658,6,5,2,1,3,1,2,50.0,1,3,0,3,0,6,1,0
9659,0,0,0,0,0,0,1,0.0,1,0,0,0,1,1,5,0
9660,11,9,6,5,0,7,7,100.0,0,9,3,6,10,21,11,0
9661,28,14,18,7,3,12,27,44.4,15,11,1,10,9,37,12,0
9662,12,6,5,3,4,3,6,50.0,3,7,0,7,4,16,13,0
9663,0,0,0,0,0,0,0,0.0,0,0,0,0,0,0,1,0
9664,7,5,4,3,0,2,6,33.3,4,3,0,3,2,9,6,0
9665,19,11,11,7,1,6,13,46.2,7,11,0,11,7,26,1,0
9666,12,11,5,6,1,9,17,52.9,8,5,2,3,3,15,12,0
9667,1,0,1,0,0,1,3,33.3,2,0,0,0,1,2,10,2
9668,26,16,18,7,1,9,14,64.3,5,23,17,6,21,47,78,0
9669,0,0,0,0,0,0,0,0.0,0,0,0,0,0,0,0,0
9670,25,15,8,11,6,9,32,28.1,23,10,1,9,7,32,4,0
9671,29,22,23,5,1,21,33,63.6,12,36,27,9,33,62,155,3
9672,18,8,7,7,4,12,22,54.5,10,20,2,18,5,23,16,1
9673,57,37,32,20,5,39,50,78.0,11,20,5,15,25,82,46,0
9674,17,9,11,6,0,9,16,56.3,7,14,7,7,17,34,23,0
9675,40,26,16,22,2,16,37,43.2,21,42,14,28,35,75,42,1
9676,9,5,3,2,4,1,6,16.7,5,7,4,3,7,16,15,0
9677,36,26,15,16,5,17,30,56.7,13,13,3,10,12,48,33,0
9678,12,5,6,6,0,7,9,77.8,2,7,4,3,7,19,13,0
9679,19,12,8,9,2,9,24,37.5,15,20,0,20,5,24,6,0
9680,44,28,24,18,2,29,46,63.0,17,25,14,11,41,85,112,0
9681,25,17,13,8,4,15,21,71.4,6,23,4,19,13,38,19,2
9682,20,13,7,10,3,14,25,56.0,11,5,2,3,8,28,1,0
9683,0,0,0,0,0,0,1,0.0,1,2,1,1,0,0,0,0
9684,11,6,3,3,5,5,8,62.5,3,4,1,3,1,12,1,0
9685,12,6,3,5,4,4,17,23.5,13,12,1,11,6,18,7,0
9686,45,29,18,23,4,19,42,45.2,23,31,7,24,40,85,31,1
9687,19,8,4,12,3,8,20,40.0,12,14,2,12,8,27,8,0
9688,13,9,8,4,1,4,12,33.3,8,11,0,11,3,16,6,0
9689,3,3,3,0,0,1,6,16.7,5,3,0,3,1,4,2,0
9690,0,0,0,0,0,0,0,0.0,0,0,0,0,0,0,0,0
9691,0,0,0,0,0,0,2,0.0,2,4,0,4,0,0,6,0
9692,0,0,0,0,0,0,0,0.0,0,0,0,0,0,0,2,0
9693,3,2,2,1,0,2,2,100.0,0,0,0,0,1,4,0,0
9694,5,2,3,1,1,3,11,27.3,8,4,3,1,7,12,0,0
9695,0,0,0,0,0,0,2,0.0,2,0,0,0,0,0,9,1
9696,25,18,15,8,2,15,26,57.7,11,15,8,7,7,32,29,0
9697,4,2,2,2,0,1,2,50.0,1,5,3,2,3,7,15,0
9698,8,4,3,5,0,1,15,6.7,14,5,0,5,5,13,7,0
9699,23,17,15,6,2,9,15,60.0,6,20,5,15,13,36,28,0
9700,6,2,3,2,1,2,10,20.0,8,12,0,12,0,6,3,0
9701,22,9,11,9,2,10,22,45.5,12,20,5,15,12,34,35,0
9702,0,0,0,0,0,0,0,0.0,0,0,0,0,0,0,10,1
9703,6,4,4,2,0,4,10,40.0,6,4,1,3,4,10,4,0
9704,20,14,13,6,1,8,16,50.0,8,8,0,8,6,26,17,0
9705,37,21,21,12,4,21,44,47.7,23,30,14,16,13,50,43,2
9706,43,23,28,14,1,28,35,80.0,7,8,3,5,27,70,35,0
9707,18,12,7,7,4,7,18,38.9,11,19,0,19,5,23,12,0
9708,18,12,9,6,3,9,13,69.2,4,10,2,8,7,25,9,1
9709,3,3,0,3,0,1,5,20.0,4,4,2,2,1,4,11,0
9710,3,1,0,2,1,1,2,50.0,1,1,1,0,1,4,3,0
9711,17,10,7,6,4,10,19,52.6,9,10,0,10,9,26,5,0
9712,64,39,38,17,9,34,53,64.2,19,31,13,18,35,99,83,1
9713,0,0,0,0,0,0,1,0.0,1,0,0,0,0,0,1,0
9714,0,0,0,0,0,0,0,0.0,0,0,0,0,0,0,1,1
9715,22,9,3,10,9,5,16,31.3,11,17,0,17,8,30,5,0
9716,17,14,5,4,8,7,29,24.1,22,17,5,12,5,22,6,0
9717,105,63,55,39,11,51,94,54.3,43,50,10,40,53,158,72,4
9718,0,0,0,0,0,0,0,0.0,0,0,0,0,0,0,1,0
9719,23,13,10,8,5,10,20,50.0,10,6,0,6,7,30,20,0
9720,14,8,6,8,0,7,17,41.2,10,20,8,12,15,29,47,2
9721,17,11,5,9,3,7,12,58.3,5,10,1,9,5,22,4,0
9722,0,0,0,0,0,0,0,0.0,0,0,0,0,1,1,0,0
9723,0,0,0,0,0,0,1,0.0,1,1,0,1,0,0,8,2
9724,1,0,1,0,0,1,3,33.3,2,0,0,0,0,1,12,2
9725,0,0,0,0,0,0,0,0.0,0,1,0,1,1,1,1,0
9726,19,12,9,8,2,12,33,36.4,21,25,3,22,7,26,15,0
9727,20,17,12,4,4,7,9,77.8,2,3,1,2,8,28,7,1
9728,35,19,23,12,0,18,34,52.9,16,19,8,11,22,57,31,1
9729,11,7,2,6,3,7,19,36.8,12,34,2,32,4,15,9,0
9730,7,4,2,5,0,1,8,12.5,7,8,1,7,6,13,2,0
9731,5,3,1,2,2,1,3,33.3,2,1,0,1,2,7,2,0
9732,64,36,19,32,13,33,61,54.1,28,37,14,23,47,111,42,1
9733,21,12,7,10,4,10,18,55.6,8,14,2,12,9,30,9,0
9734,19,13,5,8,6,12,26,46.2,14,13,1,12,12,31,2,0
9735,57,34,32,19,6,30,50,60.0,20,27,3,24,18,75,45,1
9736,7,4,4,3,0,1,7,14.3,6,2,1,1,1,8,1,0
9737,64,37,49,13,2,38,60,63.3,22,48,29,19,48,112,115,1
9738,2,1,2,0,0,2,2,100.0,0,1,0,1,3,5,9,0
9739,7,7,5,2,0,5,8,62.5,3,10,9,1,9,16,45,0
9740,48,27,30,16,2,30,53,56.6,23,42,22,20,66,114,124,1
9741,24,17,13,11,0,8,18,44.4,10,11,1,10,9,33,11,0
9742,11,7,1,4,6,4,9,44.4,5,15,4,11,3,14,13,0
9743,12,6,7,2,3,7,10,70.0,3,6,1,5,3,15,8,0
9744,30,22,18,10,2,15,28,53.6,13,44,27,17,46,76,122,2
9745,0,0,0,0,0,0,0,0.0,0,0,0,0,0,0,0,1
9746,9,4,3,3,3,4,13,30.8,9,5,1,4,3,12,6,0
9747,10,7,2,5,3,1,13,7.7,12,8,0,8,3,13,3,0
9748,17,10,10,5,2,10,17,58.8,7,14,3,11,19,36,7,1
9749,30,21,22,6,2,11,38,28.9,27,35,11,24,22,52,29,0
9750,18,5,13,2,3,9,18,50.0,9,13,5,8,21,39,33,2
9751,51,32,17,27,7,22,49,44.9,27,45,12,33,20,71,44,0
9752,35,23,14,16,5,12,38,31.6,26,24,5,19,21,56,13,0
9753,3,3,2,0,1,1,5,20.0,4,7,0,7,0,3,5,0
9754,16,11,6,3,7,10,21,47.6,11,8,1,7,5,21,7,0
9755,26,14,6,16,4,20,39,51.3,19,22,3,19,10,36,17,0
9756,6,5,3,2,1,3,4,75.0,1,3,1,2,1,7,3,0
9757,4,2,2,1,1,2,10,20.0,8,8,0,8,1,5,18,0
9758,19,12,13,5,1,13,17,76.5,4,22,18,4,15,34,82,1
9759,71,47,35,32,4,39,67,58.2,28,55,14,41,47,118,67,3
9760,87,56,39,43,5,45,92,48.9,47,67,7,60,58,145,40,2
9761,0,0,0,0,0,0,1,0.0,1,0,0,0,0,0,0,0
9762,24,12,16,6,2,20,29,69.0,9,42,31,11,23,47,92,0
9763,36,17,21,14,1,17,47,36.2,30,23,3,20,25,61,27,4
9764,4,2,1,2,1,1,3,33.3,2,1,1,0,0,4,1,0
9765,18,10,8,8,2,4,21,19.0,17,9,1,8,6,24,10,1
9766,7,4,3,3,1,2,6,33.3,4,6,1,5,3,10,5,0
9767,1,0,1,0,0,1,5,20.0,4,0,0,0,0,1,14,3
9768,19,7,6,5,8,10,17,58.8,7,11,1,10,4,23,2,0
9769,36,18,22,10,4,16,29,55.2,13,15,2,13,9,45,29,1
9770,5,4,0,4,1,1,4,25.0,3,4,0,4,4,9,1,0
9771,82,54,29,48,5,38,80,47.5,42,51,16,35,47,129,62,2
9772,3,3,2,1,0,2,4,50.0,2,7,4,3,5,8,9,0
9773,48,26,24,17,7,27,51,52.9,24,21,4,17,12,60,20,1
9774,4,3,1,2,1,1,4,25.0,3,3,0,3,1,5,0,0
9775,17,12,6,9,2,6,24,25.0,18,9,2,7,3,20,9,0
9776,14,8,7,6,1,6,15,40.0,9,11,1,10,15,29,16,0
9777,1,1,0,1,0,1,3,33.3,2,1,0,1,0,1,1,0
9778,34,14,20,9,5,20,34,58.8,14,23,15,8,24,58,92,1
9779,72,46,56,15,1,48,74,64.9,26,43,27,16,58,130,152,1
9780,13,7,6,6,1,6,16,37.5,10,10,4,6,2,15,2,0
9781,4,1,0,2,2,1,5,20.0,4,4,0,4,1,5,8,0
9782,0,0,0,0,0,0,0,0.0,0,3,1,2,0,0,3,0
9783,17,8,7,10,0,10,21,47.6,11,8,1,7,8,25,9,0
9784,0,0,0,0,0,0,0,0.0,0,0,0,0,0,0,1,0
9785,1,1,0,1,0,0,1,0.0,1,1,0,1,0,1,1,0
9786,4,2,1,1,2,1,2,50.0,1,1,0,1,0,4,2,0
9787,23,13,12,7,4,9,19,47.4,10,11,1,10,7,30,4,0
9788,19,16,11,5,3,13,20,65.0,7,3,0,3,10,29,26,0
9789,0,0,0,0,0,0,0,0.0,0,1,0,1,0,0,0,0
9790,31,22,19,12,0,17,31,54.8,14,49,32,17,27,58,201,0
9791,9,5,3,5,1,0,2,0.0,2,8,0,8,3,12,7,0
9792,1,1,1,0,0,0,0,0.0,0,0,0,0,1,2,0,0
9793,1,1,1,0,0,1,3,33.3,2,0,0,0,0,1,17,2
9794,0,0,0,0,0,0,0,0.0,0,0,0,0,0,0,16,3
9795,15,12,10,2,3,11,18,61.1,7,3,1,2,6,21,20,0
9796,2,1,2,0,0,1,2,50.0,1,3,0,3,2,4,0,0
9797,5,2,0,4,1,0,3,0.0,3,2,1,1,0,5,7,0
9798,2,2,0,2,0,2,6,33.3,4,4,0,4,1,3,1,0
9799,4,4,2,2,0,1,1,100.0,0,0,0,0,0,4,1,0
9800,11,6,5,6,0,4,6,66.7,2,2,0,2,6,17,1,0
9801,0,0,0,0,0,0,0,0.0,0,0,0,0,0,0,0,0
9802,0,0,0,0,0,0,0,0.0,0,2,1,1,0,0,0,0
9803,76,46,23,51,2,36,71,50.7,35,42,7,35,46,122,61,0
9804,1,0,1,0,0,1,1,100.0,0,0,0,0,1,2,18,1
9805,0,0,0,0,0,0,0,0.0,0,0,0,0,1,1,16,0
9806,36,25,13,15,8,18,32,56.3,14,18,1,17,6,42,10,1
9807,3,2,0,3,0,0,0,0.0,0,0,0,0,1,4,0,0
9808,14,8,7,7,0,10,19,52.6,9,7,2,5,9,23,13,0
9809,1,1,0,1,0,0,5,0.0,5,1,0,1,0,1,1,0
9810,14,12,11,3,0,8,12,66.7,4,18,9,9,21,35,60,0
9811,15,8,7,8,0,8,15,53.3,7,5,1,4,9,24,22,0
9812,32,22,11,18,3,17,33,51.5,16,20,8,12,14,46,16,2
9813,16,12,6,7,3,9,21,42.9,12,12,1,11,7,23,17,0
9814,1,0,0,0,1,0,1,0.0,1,1,1,0,0,1,1,0
9815,35,19,20,12,3,14,28,50.0,14,8,2,6,10,45,22,1
9816,33,17,9,20,4,14,40,35.0,26,20,1,19,11,44,16,0
9817,9,5,5,4,0,3,5,60.0,2,7,3,4,13,22,26,3
9818,41,19,7,23,11,25,44,56.8,19,25,0,25,14,55,7,1
9819,6,4,0,5,1,0,5,0.0,5,6,1,5,4,10,6,0
9820,0,0,0,0,0,0,1,0.0,1,1,0,1,0,0,0,0
9821,31,20,14,9,8,20,34,58.8,14,11,5,6,21,52,38,0
9822,6,5,2,2,2,4,5,80.0,1,1,0,1,0,6,3,0
9823,30,20,25,4,1,16,23,69.6,7,31,22,9,24,54,110,0
9824,0,0,0,0,0,0,0,0.0,0,0,0,0,0,0,0,0
9825,1,1,1,0,0,1,2,50.0,1,1,0,1,0,1,15,6
9826,19,14,14,4,1,9,14,64.3,5,19,13,6,29,48,77,2
9827,10,6,6,3,1,4,6,66.7,2,9,1,8,8,18,41,1
9828,13,8,7,4,2,3,9,33.3,6,2,1,1,10,23,14,1
9829,67,45,31,28,8,34,61,55.7,27,35,10,25,31,98,22,0
9830,1,0,0,1,0,0,2,0.0,2,3,0,3,1,2,1,0
9831,0,0,0,0,0,0,1,0.0,1,0,0,0,0,0,15,2
9832,48,38,26,18,4,22,40,55.0,18,32,3,29,44,92,62,2
9833,17,10,9,4,4,7,18,38.9,11,11,2,9,7,24,13,0
9834,16,8,7,4,5,9,13,69.2,4,10,2,8,2,18,17,0
9835,64,39,15,30,19,16,46,34.8,30,37,2,35,16,80,15,0
9836,10,4,1,4,5,2,13,15.4,11,22,4,18,7,17,13,0
9837,26,16,8,13,5,9,20,45.0,11,21,3,18,6,32,15,0
9838,73,51,38,23,12,41,72,56.9,31,36,8,28,43,116,53,0
9839,11,7,8,3,0,6,10,60.0,4,12,2,10,13,24,34,0
9840,43,31,15,25,3,17,36,47.2,19,32,13,19,23,66,28,0
9841,89,55,68,20,1,55,85,64.7,30,36,10,26,35,124,87,0
9842,42,28,19,13,10,23,33,69.7,10,15,3,12,13,55,24,0
9843,56,41,28,21,7,29,50,58.0,21,19,5,14,24,80,52,1
9844,13,11,5,4,4,2,4,50.0,2,16,3,13,2,15,11,0
9845,73,40,44,28,1,54,94,57.4,40,49,27,22,61,134,114,3
9846,19,13,7,7,5,9,18,50.0,9,15,4,11,22,41,33,0
9847,4,2,2,2,0,1,1,100.0,0,3,2,1,3,7,27,1
9848,5,3,2,2,1,2,3,66.7,1,9,0,9,5,10,17,0
9849,39,22,16,22,1,20,30,66.7,10,34,19,15,24,63,38,1
9850,0,0,0,0,0,0,0,0.0,0,0,0,0,1,1,10,0
9851,1,0,0,0,1,0,1,0.0,1,0,0,0,0,1,0,0
9852,33,26,8,18,7,15,48,31.3,33,20,8,12,34,67,31,1
9853,28,17,11,17,0,12,27,44.4,15,12,4,8,28,56,27,0
9854,53,28,19,26,8,17,48,35.4,31,27,0,27,17,70,8,0
9855,7,5,7,0,0,3,7,42.9,4,5,0,5,3,10,4,0
9856,31,16,19,10,2,17,21,81.0,4,17,9,8,22,53,75,0
9857,12,9,6,5,1,5,7,71.4,2,4,1,3,2,14,16,0
9858,0,0,0,0,0,0,1,0.0,1,0,0,0,0,0,4,0
9859,1,0,0,1,0,0,0,0.0,0,0,0,0,0,1,0,0
9860,21,15,11,8,2,10,15,66.7,5,17,12,5,19,40,59,1
9861,1,0,1,0,0,0,1,0.0,1,5,0,5,2,3,3,0
9862,6,4,0,5,1,0,7,0.0,7,3,1,2,1,7,6,0
9863,37,28,14,21,2,20,43,46.5,23,20,6,14,17,54,35,1
9864,2,2,0,2,0,0,1,0.0,1,0,0,0,1,3,0,0
9865,15,8,9,5,1,7,20,35.0,13,9,2,7,7,22,14,0
9866,2,2,1,1,0,0,0,0.0,0,0,0,0,0,2,0,0
9867,4,2,1,2,1,3,5,60.0,2,8,0,8,4,8,1,0
9868,0,0,0,0,0,0,0,0.0,0,0,0,0,0,0,1,0
9869,23,13,8,10,5,17,22,77.3,5,24,16,8,29,52,56,0
9870,21,19,12,7,2,18,20,90.0,2,20,9,11,13,34,40,0
9871,9,4,6,2,1,8,11,72.7,3,5,1,4,2,11,5,0
9872,6,3,0,4,2,1,5,20.0,4,7,2,5,1,7,19,0
9873,18,10,12,6,0,6,13,46.2,7,7,3,4,16,34,20,0
9874,26,17,12,12,2,20,31,64.5,11,13,1,12,15,41,23,0
9875,10,7,6,3,1,6,12,50.0,6,5,3,2,3,13,16,0
9876,60,42,37,15,8,34,60,56.7,26,38,2,36,31,91,44,0
9877,68,46,22,39,7,30,59,50.8,29,62,17,45,53,121,77,1
9878,31,17,16,10,5,15,29,51.7,14,14,2,12,8,39,31,0
9879,8,2,2,3,3,4,9,44.4,5,7,2,5,1,9,16,0
9880,4,3,2,2,0,1,3,33.3,2,4,1,3,7,11,10,0
9881,19,11,8,7,4,9,32,28.1,23,27,1,26,17,36,12,0
9882,60,44,34,21,5,35,53,66.0,18,33,14,19,34,94,70,0
9883,37,21,23,8,6,10,37,27.0,27,28,4,24,28,65,34,1
9884,72,47,23,40,9,41,66,62.1,25,62,18,44,63,135,94,0
9885,16,7,4,10,2,5,12,41.7,7,32,5,27,10,26,40,0
9886,47,32,11,24,12,16,45,35.6,29,19,3,16,9,56,15,0
9887,0,0,0,0,0,0,0,0.0,0,0,0,0,0,0,0,0
9888,17,12,8,7,2,11,20,55.0,9,20,4,16,11,28,23,0
9889,32,22,22,10,0,19,35,54.3,16,17,6,11,45,77,62,1
9890,119,80,51,59,9,49,103,47.6,54,53,10,43,34,153,42,2
9891,13,9,6,4,3,4,18,22.2,14,17,4,13,13,26,27,0
9892,21,11,6,9,6,7,32,21.9,25,19,3,16,5,26,17,0
9893,100,56,36,49,15,36,87,41.4,51,36,8,28,42,142,25,0
9894,15,11,1,8,6,10,22,45.5,12,10,0,10,8,23,10,0
9895,3,3,1,2,0,0,2,0.0,2,1,0,1,0,3,8,0
9896,16,10,2,8,6,5,12,41.7,7,21,1,20,3,19,8,0
9897,19,12,13,6,0,9,11,81.8,2,15,11,4,23,42,31,0
9898,38,21,28,10,0,20,30,66.7,10,31,21,10,30,68,68,0
9899,29,19,10,14,5,8,42,19.0,34,36,3,33,17,46,16,1
9900,7,4,3,3,1,3,6,50.0,3,6,0,6,3,10,8,0
9901,3,2,1,0,2,2,3,66.7,1,2,0,2,0,3,1,0
9902,3,1,0,1,2,3,5,60.0,2,1,0,1,0,3,0,0
9903,31,17,13,8,10,10,24,41.7,14,16,3,13,9,40,9,0
9904,34,20,8,20,6,21,31,67.7,10,20,4,16,6,40,25,0
9905,67,49,42,21,4,34,56,60.7,22,21,3,18,43,110,50,0
9906,6,2,4,1,1,2,5,40.0,3,9,2,7,4,10,7,0
9907,2,2,1,0,1,1,2,50.0,1,0,0,0,0,2,2,0
9908,11,9,3,6,2,4,6,66.7,2,16,1,15,9,20,35,0
9909,4,4,1,2,1,2,2,100.0,0,2,1,1,1,5,0,0
9910,27,18,14,13,0,14,30,46.7,16,12,4,8,11,38,16,0
9911,11,9,5,4,2,2,3,66.7,1,9,0,9,0,11,0,0
9912,3,2,1,2,0,1,4,25.0,3,6,1,5,0,3,3,0
9913,7,5,3,4,0,0,2,0.0,2,8,1,7,1,8,5,0
9914,1,0,1,0,0,1,1,100.0,0,0,0,0,0,1,7,0
9915,25,10,11,11,3,14,27,51.9,13,10,2,8,8,33,6,1
9916,37,26,15,15,7,14,29,48.3,15,19,3,16,29,66,25,0
9917,50,34,23,21,6,31,56,55.4,25,40,8,32,29,79,56,0
9918,6,5,3,3,0,2,3,66.7,1,0,0,0,1,7,1,0
9919,0,0,0,0,0,0,1,0.0,1,1,0,1,0,0,0,0
9920,49,24,14,24,11,14,56,25.0,42,38,3,35,23,72,11,0
9921,64,39,35,26,3,27,42,64.3,15,27,7,20,30,94,89,1
9922,7,4,2,5,0,1,5,20.0,4,3,0,3,2,9,4,0
9923,8,5,2,5,1,4,7,57.1,3,7,5,2,11,19,5,0
9924,31,19,26,5,0,13,21,61.9,8,24,19,5,28,59,87,3
9925,7,4,0,5,2,2,6,33.3,4,2,0,2,4,11,5,0
9926,2,0,1,1,0,0,1,0.0,1,0,0,0,1,3,0,0
9927,36,19,12,12,12,10,41,24.4,31,27,1,26,11,47,10,1
9928,24,17,10,12,2,14,23,60.9,9,10,4,6,18,42,21,1
9929,27,20,10,14,3,15,24,62.5,9,6,2,4,4,31,11,0
9930,6,4,3,3,0,2,9,22.2,7,9,2,7,0,6,10,0
9931,29,23,19,8,2,16,31,51.6,15,20,10,10,24,53,60,0
9932,6,3,3,3,0,3,8,37.5,5,8,3,5,6,12,43,1
9933,9,5,3,5,1,6,8,75.0,2,9,3,6,16,25,42,0
9934,1,1,1,0,0,0,2,0.0,2,5,1,4,1,2,5,0
9935,67,44,47,17,3,37,68,54.4,31,34,8,26,29,96,70,3
9936,0,0,0,0,0,0,0,0.0,0,1,0,1,0,0,1,0
9937,2,2,0,1,1,0,4,0.0,4,9,1,8,3,5,4,0
9938,0,0,0,0,0,0,0,0.0,0,0,0,0,2,2,2,0
9939,1,1,0,1,0,1,3,33.3,2,0,0,0,0,1,2,0
9940,8,3,3,2,3,2,10,20.0,8,8,0,8,2,10,3,0
9941,20,15,6,12,2,11,28,39.3,17,15,0,15,13,33,6,0
9942,12,7,2,5,5,3,9,33.3,6,11,1,10,5,17,2,0
9943,28,16,20,7,1,21,34,61.8,13,29,19,10,33,61,98,1
9944,15,5,4,10,1,8,23,34.8,15,9,0,9,5,20,7,0
9945,27,13,7,13,7,17,40,42.5,23,34,15,19,30,57,29,0
9946,0,0,0,0,0,0,0,0.0,0,1,0,1,0,0,8,2
9947,3,1,3,0,0,0,4,0.0,4,30,20,10,20,23,47,1
9948,26,16,15,9,2,15,25,60.0,10,30,19,11,30,56,120,0
9949,44,28,27,15,2,37,59,62.7,22,32,12,20,30,74,106,0
9950,5,3,2,2,1,0,4,0.0,4,7,0,7,2,7,0,0
9951,33,21,12,15,6,15,23,65.2,8,22,6,16,35,68,34,1
9952,62,37,44,14,4,34,66,51.5,32,50,10,40,30,92,93,2
9953,31,25,13,16,2,15,40,37.5,25,31,2,29,24,55,13,1
9954,5,2,2,2,1,2,4,50.0,2,3,1,2,1,6,16,0
9955,4,2,1,2,1,2,5,40.0,3,11,7,4,1,5,17,0
9956,38,24,19,16,3,16,29,55.2,13,23,5,18,19,57,27,0
9957,26,16,7,15,4,11,31,35.5,20,12,2,10,6,32,14,0
9958,18,13,12,6,0,12,22,54.5,10,16,8,8,11,29,33,0
9959,30,22,15,14,1,19,39,48.7,20,28,9,19,22,52,57,1
9960,18,9,10,6,2,7,27,25.9,20,18,1,17,17,35,16,2
9961,2,2,0,2,0,0,1,0.0,1,3,0,3,2,4,1,1
9962,17,10,5,7,5,10,22,45.5,12,15,6,9,9,26,12,1
9963,0,0,0,0,0,0,2,0.0,2,0,0,0,0,0,2,0
9964,35,18,20,7,8,21,42,50.0,21,22,4,18,14,49,26,0
9965,16,8,6,7,3,9,13,69.2,4,7,1,6,4,20,9,0
9966,36,24,20,15,1,17,26,65.4,9,15,4,11,23,59,47,0
9967,35,22,8,23,4,12,35,34.3,23,16,1,15,21,56,31,0
9968,0,0,0,0,0,0,0,0.0,0,0,0,0,0,0,4,0
9969,38,23,8,18,12,13,34,38.2,21,33,1,32,8,46,15,0
9970,17,9,13,4,0,7,18,38.9,11,31,21,10,28,45,149,0
9971,19,13,10,6,3,7,23,30.4,16,14,4,10,13,32,14,0
9972,0,0,0,0,0,0,4,0.0,4,1,0,1,2,2,0,0
9973,18,11,12,5,1,6,13,46.2,7,16,12,4,25,43,59,0
9974,34,23,12,16,6,11,33,33.3,22,29,6,23,8,42,33,0
9975,5,2,1,3,1,3,7,42.9,4,1,0,1,0,5,0,0
9976,5,4,4,1,0,3,6,50.0,3,4,4,0,6,11,4,0
9977,0,0,0,0,0,0,0,0.0,0,0,0,0,0,0,0,0
9978,2,1,2,0,0,2,3,66.7,1,0,0,0,0,2,3,0
9979,1,1,0,1,0,1,1,100.0,0,3,2,1,1,2,1,0
9980,64,38,48,14,2,32,69,46.4,37,50,30,20,33,97,116,6
9981,15,12,10,3,2,7,21,33.3,14,8,0,8,4,19,1,0
9982,17,9,10,4,3,12,23,52.2,11,6,0,6,3,20,6,0
9983,42,30,20,18,4,21,50,42.0,29,31,16,15,29,71,86,0
9984,21,8,10,6,5,11,19,57.9,8,25,7,18,20,41,43,0
9985,0,0,0,0,0,0,1,0.0,1,0,0,0,0,0,0,0
9986,11,5,4,1,6,3,8,37.5,5,6,1,5,4,15,9,0
9987,1,0,1,0,0,0,0,0.0,0,0,0,0,2,3,0,0
9988,3,1,1,1,1,1,2,50.0,1,1,1,0,0,3,1,0
9989,19,12,11,6,2,9,15,60.0,6,9,5,4,10,29,30,1
9990,55,34,34,19,2,26,68,38.2,42,36,8,28,34,89,38,0
9991,4,4,1,1,2,2,4,50.0,2,2,0,2,1,5,4,0
9992,2,1,2,0,0,2,3,66.7,1,0,0,0,1,3,18,1
9993,4,3,4,0,0,3,5,60.0,2,0,0,0,0,4,18,4
9994,43,30,30,13,0,23,35,65.7,12,29,17,12,58,101,166,0
9995,43,23,27,16,0,27,39,69.2,12,57,40,17,34,77,168,0
9996,14,11,1,8,5,8,13,61.5,5,5,0,5,4,18,16,0
9997,18,12,15,3,0,11,13,84.6,2,17,13,4,16,34,94,0
9998,43,30,30,11,2,26,42,61.9,16,21,3,18,22,65,20,0
9999,23,14,16,4,3,10,19,52.6,9,6,2,4,15,38,24,0
10000,53,34,28,20,5,31,62,50.0,31,30,9,21,21,74,45,1
10001,3,1,2,1,0,1,2,50.0,1,1,0,1,1,4,0,0
10002,57,39,47,9,1,36,47,76.6,11,38,17,21,43,100,166,0
10003,11,5,3,6,2,6,9,66.7,3,4,0,4,2,13,5,0
10004,9,5,5,4,0,4,10,40.0,6,5,0,5,4,13,3,0
10005,37,19,16,18,3,24,37,64.9,13,12,2,10,17,54,7,1
10006,15,7,5,8,2,6,17,35.3,11,7,1,6,6,21,4,0
10007,24,16,13,7,4,15,20,75.0,5,15,3,12,13,37,22,1
10008,63,40,38,19,6,31,52,59.6,21,33,8,25,38,101,73,0
10009,13,11,3,9,1,4,7,57.1,3,6,1,5,1,14,11,0
10010,0,0,0,0,0,0,0,0.0,0,1,0,1,1,1,0,0
10011,64,38,41,19,4,33,54,61.1,21,36,6,30,20,84,70,0
10012,74,39,28,36,10,29,65,44.6,36,42,11,31,39,113,54,0
10013,4,2,0,1,3,3,5,60.0,2,2,0,2,0,4,2,0
10014,1,1,0,1,0,0,2,0.0,2,1,0,1,0,1,6,0
10015,0,0,0,0,0,0,0,0.0,0,1,0,1,0,0,0,0
10016,56,30,20,32,4,22,45,48.9,23,19,3,16,8,64,21,1
10017,49,25,23,19,7,23,47,48.9,24,19,4,15,19,68,29,1
10018,0,0,0,0,0,0,0,0.0,0,1,0,1,0,0,0,0
10019,72,48,25,36,11,31,78,39.7,47,42,10,32,46,118,46,0
10020,12,7,7,5,0,7,13,53.8,6,21,14,7,11,23,109,1
10021,18,16,3,11,4,2,5,40.0,3,6,0,6,1,19,6,0
10022,0,0,0,0,0,0,0,0.0,0,2,0,2,0,0,0,0
10023,65,34,31,31,3,32,63,50.8,31,28,11,17,26,91,40,0
10024,2,1,0,2,0,1,1,100.0,0,1,0,1,0,2,1,0
10025,19,11,11,7,1,6,13,46.2,7,30,18,12,31,50,81,0
10026,32,23,15,15,2,20,44,45.5,24,32,9,23,32,64,24,0
10027,32,21,15,15,2,14,26,53.8,12,22,2,20,17,49,15,0
10028,16,6,7,6,3,9,14,64.3,5,8,1,7,6,22,22,0
10029,35,22,27,6,2,18,30,60.0,12,66,47,19,33,68,187,2
10030,8,6,2,4,2,7,8,87.5,1,5,1,4,3,11,7,0
10031,17,13,11,6,0,10,15,66.7,5,14,8,6,16,33,28,0
10032,0,0,0,0,0,0,1,0.0,1,1,0,1,1,1,1,0
10033,80,50,53,21,6,42,60,70.0,18,33,11,22,25,105,59,0
10034,20,8,15,4,1,7,13,53.8,6,12,9,3,19,39,25,0
10035,34,18,18,10,6,18,36,50.0,18,23,6,17,22,56,25,2
10036,18,12,6,10,2,10,15,66.7,5,16,1,15,9,27,17,0
10037,16,12,7,5,4,11,24,45.8,13,15,3,12,5,21,17,0
10038,2,2,2,0,0,2,3,66.7,1,1,1,0,1,3,5,0
10039,1,1,1,0,0,1,2,50.0,1,6,0,6,1,2,5,0
10040,6,4,2,1,3,4,7,57.1,3,2,0,2,1,7,0,0
10041,2,0,1,0,1,1,5,20.0,4,2,0,2,1,3,0,0
10042,23,11,12,10,1,14,21,66.7,7,21,14,7,30,53,74,1
10043,33,22,16,14,3,14,45,31.1,31,41,11,30,22,55,42,2
10044,20,12,4,8,8,8,22,36.4,14,10,1,9,6,26,11,0
10045,29,18,14,13,2,16,35,45.7,19,56,15,41,22,51,64,0
10046,3,3,0,0,3,0,3,0.0,3,3,0,3,0,3,8,0
10047,10,7,2,5,3,2,9,22.2,7,4,0,4,1,11,16,0
10048,16,12,8,6,2,11,14,78.6,3,7,4,3,9,25,27,0
10049,7,3,1,6,0,4,9,44.4,5,4,1,3,8,15,13,0
10050,18,8,3,8,7,8,15,53.3,7,10,4,6,5,23,9,1
10051,15,9,5,8,2,3,6,50.0,3,11,6,5,3,18,30,0
10052,0,0,0,0,0,0,0,0.0,0,0,0,0,0,0,0,0
10053,7,1,6,1,0,2,2,100.0,0,1,0,1,1,8,0,0
10054,114,71,52,49,13,55,110,50.0,55,43,13,30,46,160,39,0
10055,48,29,27,21,0,22,31,71.0,9,38,28,10,59,107,132,0
10056,8,5,3,3,2,3,6,50.0,3,11,0,11,4,12,4,0
10057,41,28,26,9,6,17,25,68.0,8,34,7,27,29,70,68,1
10058,18,9,7,8,3,12,22,54.5,10,33,5,28,12,30,38,0
10059,17,14,8,7,2,8,28,28.6,20,21,7,14,7,24,34,0
10060,0,0,0,0,0,0,1,0.0,1,3,1,2,0,0,1,0
10061,24,11,15,9,0,5,14,35.7,9,10,5,5,8,32,14,0
10062,29,17,16,9,4,11,25,44.0,14,28,10,18,17,46,17,0
10063,27,18,4,16,7,12,27,44.4,15,15,2,13,9,36,3,0
10064,7,4,2,4,1,0,4,0.0,4,6,2,4,1,8,13,0
10065,5,4,1,1,3,1,5,20.0,4,11,0,11,3,8,1,0
10066,33,20,14,15,4,5,14,35.7,9,19,0,19,28,61,6,0
10067,8,5,1,4,3,1,1,100.0,0,3,1,2,1,9,10,0
10068,6,2,2,4,0,1,2,50.0,1,11,3,8,4,10,10,0
10069,8,4,3,4,1,1,7,14.3,6,7,1,6,3,11,8,0
10070,13,8,1,10,2,3,23,13.0,20,11,0,11,7,20,6,0
10071,29,20,16,11,2,18,35,51.4,17,7,0,7,15,44,23,0
10072,11,2,2,7,2,7,13,53.8,6,5,0,5,2,13,2,0
10073,5,3,2,2,1,2,5,40.0,3,4,1,3,2,7,5,0
10074,5,2,0,4,1,0,2,0.0,2,2,0,2,1,6,2,0
10075,1,1,0,1,0,0,0,0.0,0,0,0,0,0,1,1,0
10076,102,59,36,56,10,52,96,54.2,44,49,16,33,36,138,45,1
10077,0,0,0,0,0,0,0,0.0,0,0,0,0,0,0,0,0
10078,2,1,0,2,0,1,1,100.0,0,0,0,0,0,2,0,0
10079,0,0,0,0,0,0,0,0.0,0,0,0,0,0,0,0,0
10080,0,0,0,0,0,0,0,0.0,0,0,0,0,0,0,0,0
10081,19,13,7,10,2,8,23,34.8,15,24,2,22,11,30,27,0
10082,0,0,0,0,0,0,0,0.0,0,0,0,0,0,0,0,0
10083,48,33,37,11,0,24,41,58.5,17,25,1,24,40,88,43,1
10084,1,1,1,0,0,1,1,100.0,0,0,0,0,0,1,3,1
10085,90,56,30,48,12,54,102,52.9,48,46,12,34,37,127,52,0
10086,51,29,22,21,8,25,42,59.5,17,34,9,25,29,80,15,2
10087,0,0,0,0,0,0,0,0.0,0,0,0,0,0,0,0,0
10088,0,0,0,0,0,0,0,0.0,0,0,0,0,0,0,10,2
10089,27,14,19,8,0,16,35,45.7,19,26,15,11,26,53,121,0
10090,44,27,27,15,2,24,37,64.9,13,18,10,8,24,68,50,0
10091,0,0,0,0,0,0,1,0.0,1,0,0,0,0,0,0,0
10092,7,6,4,0,3,3,4,75.0,1,5,0,5,5,12,3,0
10093,0,0,0,0,0,0,0,0.0,0,0,0,0,1,1,0,0
10094,16,10,5,11,0,5,17,29.4,12,25,6,19,9,25,39,0
10095,28,18,20,7,1,12,22,54.5,10,16,11,5,32,60,79,1
10096,2,2,0,2,0,0,6,0.0,6,7,1,6,1,3,4,0
10097,47,29,33,12,2,27,42,64.3,15,36,23,13,40,87,106,1
10098,32,17,20,12,0,18,32,56.3,14,32,10,22,25,57,57,0
10099,3,1,1,2,0,1,5,20.0,4,1,1,0,0,3,4,0
10100,0,0,0,0,0,0,0,0.0,0,1,0,1,1,1,1,0
10101,3,1,0,3,0,2,4,50.0,2,4,1,3,5,8,2,0
10102,51,32,31,19,1,21,38,55.3,17,19,2,17,33,84,30,1
10103,11,7,7,4,0,9,16,56.3,7,9,3,6,4,15,10,0
10104,70,50,36,25,9,35,79,44.3,44,46,0,46,19,89,11,0
10105,16,9,10,4,2,7,11,63.6,4,15,9,6,23,39,75,0
10106,1,0,1,0,0,1,1,100.0,0,0,0,0,0,1,10,0
10107,30,21,23,5,2,17,24,70.8,7,40,26,14,41,71,194,1
10108,7,4,3,4,0,3,13,23.1,10,7,0,7,5,12,5,0
10109,6,4,4,2,0,5,10,50.0,5,3,2,1,2,8,18,0
10110,14,6,5,9,0,4,9,44.4,5,13,9,4,8,22,37,1
10111,39,20,26,13,0,21,37,56.8,16,36,13,23,21,60,58,2
10112,24,17,13,9,2,8,22,36.4,14,18,1,17,12,36,12,0
10113,8,4,5,2,1,4,9,44.4,5,6,3,3,2,10,7,0
10114,18,11,9,9,0,6,7,85.7,1,7,4,3,19,37,21,0
10115,7,7,1,5,1,5,12,41.7,7,3,0,3,1,8,0,0
10116,13,8,7,3,3,6,27,22.2,21,14,1,13,8,21,9,0
10117,0,0,0,0,0,0,0,0.0,0,0,0,0,0,0,0,0
10118,0,0,0,0,0,0,0,0.0,0,0,0,0,0,0,0,0
10119,25,15,8,9,8,14,47,29.8,33,33,5,28,16,41,24,0
10120,30,21,18,11,1,15,24,62.5,9,12,5,7,14,44,27,1
10121,34,21,12,16,6,15,44,34.1,29,22,1,21,11,45,24,0
10122,10,7,3,4,3,3,13,23.1,10,5,0,5,7,17,3,0
10123,7,2,1,5,1,1,4,25.0,3,3,0,3,2,9,1,0
10124,32,21,11,17,4,10,26,38.5,16,22,8,14,10,42,24,0
10125,0,0,0,0,0,0,0,0.0,0,3,0,3,0,0,2,0
10126,4,2,3,1,0,3,5,60.0,2,1,0,1,4,8,9,0
10127,0,0,0,0,0,0,0,0.0,0,0,0,0,0,0,0,0
10128,0,0,0,0,0,0,1,0.0,1,1,0,1,0,0,1,0
10129,22,14,7,12,3,10,15,66.7,5,9,0,9,8,30,8,0
10130,0,0,0,0,0,0,0,0.0,0,0,0,0,0,0,11,1
10131,44,29,26,13,5,27,47,57.4,20,31,3,28,30,74,59,0
10132,3,2,2,1,0,2,4,50.0,2,0,0,0,0,3,2,0
10133,57,33,28,22,7,40,72,55.6,32,25,14,11,35,92,55,1
10134,0,0,0,0,0,0,0,0.0,0,0,0,0,0,0,0,0
10135,10,8,9,0,1,5,7,71.4,2,1,1,0,6,16,10,0
10136,30,16,8,15,7,14,22,63.6,8,16,0,16,5,35,8,0
10137,3,3,3,0,0,2,5,40.0,3,2,0,2,3,6,7,0
10138,22,13,18,4,0,11,17,64.7,6,31,20,11,22,44,99,1
10139,2,1,1,1,0,0,0,0.0,0,0,0,0,0,2,1,0
10140,17,10,12,5,0,14,21,66.7,7,21,17,4,24,41,68,1
10141,42,26,11,22,9,20,39,51.3,19,38,20,18,33,75,63,0
10142,4,2,2,1,1,1,2,50.0,1,4,0,4,4,8,4,0
10143,37,19,20,9,8,19,36,52.8,17,27,1,26,16,53,17,0
10144,6,4,2,2,2,4,6,66.7,2,5,0,5,1,7,7,0
10145,15,7,3,9,3,6,22,27.3,16,16,1,15,5,20,1,0
10146,0,0,0,0,0,0,0,0.0,0,1,0,1,0,0,0,0
10147,8,5,4,2,2,5,18,27.8,13,16,1,15,8,16,7,0
10148,55,30,26,24,5,35,66,53.0,31,23,7,16,29,84,33,0
10149,0,0,0,0,0,0,0,0.0,0,0,0,0,0,0,1,0
10150,31,13,20,8,3,19,26,73.1,7,47,35,12,47,78,134,3
10151,5,5,1,2,2,2,5,40.0,3,7,0,7,0,5,4,0
10152,22,13,11,11,0,11,15,73.3,4,18,6,12,21,43,54,0
10153,0,0,0,0,0,0,0,0.0,0,0,0,0,0,0,0,0
10154,10,5,7,3,0,5,7,71.4,2,5,2,3,10,20,16,0
10155,39,21,22,11,6,20,28,71.4,8,24,8,16,27,66,74,0
10156,8,5,0,5,3,3,15,20.0,12,6,1,5,10,18,0,0
10157,8,8,1,3,4,1,9,11.1,8,9,2,7,7,15,8,0
10158,0,0,0,0,0,0,6,0.0,6,4,0,4,1,1,8,0
10159,9,5,7,2,0,4,14,28.6,10,22,19,3,13,22,57,1
10160,1,1,0,1,0,1,1,100.0,0,1,0,1,0,1,0,0
10161,8,8,1,5,2,2,5,40.0,3,6,2,4,2,10,10,0
10162,56,33,20,25,11,33,67,49.3,34,42,5,37,37,93,56,1
10163,35,24,13,18,4,19,41,46.3,22,17,0,17,8,43,4,0
10164,12,10,7,5,0,6,15,40.0,9,4,0,4,8,20,18,0
10165,10,5,2,6,2,6,15,40.0,9,7,1,6,5,15,9,0
10166,0,0,0,0,0,0,0,0.0,0,0,0,0,0,0,0,0
10167,32,17,9,19,4,14,39,35.9,25,13,2,11,20,52,15,1
10168,21,12,10,7,4,5,19,26.3,14,6,0,6,6,27,2,0
10169,14,7,3,8,3,6,15,40.0,9,14,2,12,10,24,41,0
10170,4,2,3,1,0,0,1,0.0,1,2,1,1,0,4,1,0
10171,24,14,5,11,8,9,32,28.1,23,11,1,10,9,33,1,2
10172,30,20,23,7,0,19,24,79.2,5,21,10,11,12,42,122,1
10173,4,0,1,2,1,2,7,28.6,5,3,0,3,1,5,10,1
10174,7,3,4,3,0,4,8,50.0,4,18,12,6,10,17,38,1
10175,10,8,6,3,1,5,12,41.7,7,4,1,3,8,18,15,0
10176,42,27,24,14,4,28,57,49.1,29,43,7,36,17,59,48,3
10177,10,8,7,2,1,6,12,50.0,6,6,2,4,5,15,13,0
10178,46,28,31,11,4,29,68,42.6,39,22,3,19,14,60,30,0
10179,35,16,15,19,1,11,23,47.8,12,14,1,13,18,53,27,0
10180,0,0,0,0,0,0,0,0.0,0,0,0,0,0,0,0,0
10181,0,0,0,0,0,0,0,0.0,0,0,0,0,0,0,2,0
10182,1,0,1,0,0,0,2,0.0,2,2,0,2,1,2,2,1
10183,10,6,5,4,1,6,9,66.7,3,3,0,3,4,14,1,0
10184,0,0,0,0,0,0,0,0.0,0,0,0,0,0,0,1,2
10185,6,3,1,4,1,4,7,57.1,3,1,0,1,2,8,2,0
10186,0,0,0,0,0,0,0,0.0,0,0,0,0,0,0,0,0
10187,61,31,22,30,9,30,79,38.0,49,27,13,14,57,118,66,0
10188,1,1,0,0,1,1,3,33.3,2,1,1,0,2,3,3,0
10189,42,26,14,23,5,19,37,51.4,18,10,3,7,15,57,21,0
10190,45,35,29,12,4,22,40,55.0,18,38,6,32,25,70,48,0
10191,30,18,17,10,3,15,42,35.7,27,19,4,15,30,60,30,2
10192,0,0,0,0,0,0,0,0.0,0,0,0,0,0,0,0,0
10193,55,30,40,14,1,33,50,66.0,17,36,21,15,43,98,104,2
10194,3,2,2,1,0,2,2,100.0,0,3,1,2,2,5,3,0
10195,52,36,26,16,10,36,85,42.4,49,27,8,19,21,73,65,1
10196,11,9,5,6,0,5,11,45.5,6,3,0,3,4,15,5,0
10197,1,1,1,0,0,0,0,0.0,0,0,0,0,0,1,18,2
10198,6,1,2,3,1,4,5,80.0,1,7,1,6,1,7,2,0
10199,26,19,12,11,3,11,30,36.7,19,12,2,10,11,37,7,0
10200,6,5,2,4,0,3,7,42.9,4,1,0,1,2,8,2,0
10201,52,35,42,9,1,23,32,71.9,9,26,15,11,41,93,154,1
10202,0,0,0,0,0,0,0,0.0,0,0,0,0,0,0,0,0
10203,12,8,4,7,1,8,12,66.7,4,10,4,6,4,16,26,0
10204,0,0,0,0,0,0,0,0.0,0,2,0,2,0,0,1,0
10205,55,35,24,25,6,22,38,57.9,16,38,5,33,34,89,31,1
10206,22,13,8,10,4,9,22,40.9,13,11,1,10,17,39,14,0
10207,23,11,5,9,9,8,27,29.6,19,46,5,41,12,35,21,0
10208,0,0,0,0,0,0,0,0.0,0,0,0,0,0,0,8,1
10209,11,4,9,0,2,4,9,44.4,5,23,13,10,27,38,69,0
10210,29,20,20,6,3,13,27,48.1,14,26,20,6,45,74,151,1
10211,2,0,0,1,1,1,1,100.0,0,2,2,0,2,4,1,0
10212,41,25,15,22,4,19,52,36.5,33,27,2,25,17,58,12,0
10213,17,11,11,5,1,5,13,38.5,8,8,3,5,6,23,34,1
10214,36,22,21,9,6,21,39,53.8,18,30,14,16,22,58,87,0
10215,4,2,3,1,0,4,7,57.1,3,6,5,1,7,11,22,0
10216,0,0,0,0,0,0,1,0.0,1,0,0,0,0,0,18,1
10217,5,4,4,1,0,3,7,42.9,4,2,1,1,4,9,5,0
10218,8,6,7,1,0,3,7,42.9,4,11,5,6,7,15,27,0
10219,0,0,0,0,0,0,0,0.0,0,0,0,0,0,0,1,0
10220,0,0,0,0,0,0,0,0.0,0,0,0,0,1,1,2,0
10221,4,2,0,2,2,2,6,33.3,4,1,0,1,1,5,1,0
10222,20,16,9,11,0,10,18,55.6,8,3,2,1,7,27,14,0
10223,0,0,0,0,0,0,1,0.0,1,0,0,0,0,0,10,3
10224,0,0,0,0,0,0,0,0.0,0,0,0,0,0,0,0,0
10225,5,4,2,2,1,2,4,50.0,2,4,2,2,4,9,2,0
10226,18,6,4,13,1,7,24,29.2,17,25,7,18,17,35,14,2
10227,4,4,3,1,0,3,5,60.0,2,9,5,4,4,8,38,0
10228,18,13,10,8,0,11,22,50.0,11,26,11,15,14,32,40,1
10229,55,27,16,34,5,24,56,42.9,32,19,3,16,25,80,24,0
10230,1,1,1,0,0,1,1,100.0,0,0,0,0,1,2,0,0
10231,1,1,1,0,0,0,0,0.0,0,1,0,1,1,2,1,0
10232,11,6,3,6,2,4,13,30.8,9,10,1,9,5,16,11,0
10233,10,6,0,6,4,5,8,62.5,3,14,4,10,1,11,20,0
10234,39,26,18,16,5,16,28,57.1,12,22,6,16,28,67,29,2
10235,102,67,50,43,9,45,101,44.6,56,49,7,42,72,174,54,0
10236,8,6,4,3,1,2,14,14.3,12,8,1,7,0,8,24,0
10237,21,16,9,11,1,12,23,52.2,11,8,4,4,10,31,26,0
10238,13,6,5,3,5,5,14,35.7,9,11,1,10,5,18,9,0
10239,0,0,0,0,0,0,3,0.0,3,0,0,0,0,0,6,0
10240,0,0,0,0,0,0,0,0.0,0,0,0,0,0,0,0,0
10241,14,8,5,6,3,9,16,56.3,7,12,1,11,7,21,7,0
10242,0,0,0,0,0,0,1,0.0,1,2,0,2,1,1,0,0
10243,2,1,1,0,1,2,5,40.0,3,2,0,2,2,4,0,0
10244,28,20,16,10,2,15,21,71.4,6,36,24,12,29,57,127,0
10245,16,13,12,3,1,13,20,65.0,7,5,2,3,15,31,32,0
10246,41,26,23,9,9,22,51,43.1,29,41,6,35,32,73,81,2
10247,1,0,0,1,0,1,1,100.0,0,0,0,0,0,1,0,0
10248,29,18,9,14,6,15,26,57.7,11,18,5,13,20,49,37,0
10249,0,0,0,0,0,0,0,0.0,0,0,0,0,0,0,5,2
10250,0,0,0,0,0,0,0,0.0,0,0,0,0,0,0,2,0
10251,0,0,0,0,0,0,0,0.0,0,0,0,0,0,0,1,0
10252,21,14,12,9,0,10,23,43.5,13,13,1,12,12,33,15,1
10253,49,28,21,18,10,18,38,47.4,20,33,7,26,30,79,44,1
10254,22,14,6,15,1,9,16,56.3,7,10,1,9,2,24,13,0
10255,15,11,9,6,0,11,11,100.0,0,11,3,8,11,26,19,0
10256,38,28,20,16,2,17,34,50.0,17,31,9,22,14,52,53,0
10257,0,0,0,0,0,0,2,0.0,2,3,0,3,0,0,2,0
10258,6,4,3,3,0,4,10,40.0,6,9,0,9,5,11,2,0
10259,0,0,0,0,0,0,0,0.0,0,0,0,0,0,0,1,0
10260,0,0,0,0,0,0,0,0.0,0,0,0,0,0,0,0,0
10261,17,7,3,9,5,5,13,38.5,8,20,3,17,3,20,7,0
10262,11,5,1,5,5,2,13,15.4,11,14,3,11,3,14,8,0
10263,0,0,0,0,0,0,0,0.0,0,0,0,0,0,0,0,0
10264,10,5,7,3,0,8,14,57.1,6,6,0,6,10,20,11,0
10265,7,6,5,1,1,4,9,44.4,5,2,0,2,2,9,11,0
10266,38,24,23,12,3,16,31,51.6,15,27,8,19,27,65,39,0
10267,24,15,16,7,1,16,27,59.3,11,9,5,4,19,43,10,0
10268,60,46,30,21,9,29,50,58.0,21,26,5,21,26,86,29,1
10269,17,11,6,7,4,8,22,36.4,14,8,0,8,3,20,5,0
10270,36,23,13,16,7,15,29,51.7,14,14,4,10,14,50,43,0
10271,0,0,0,0,0,0,0,0.0,0,0,0,0,0,0,4,1
10272,19,9,10,8,1,13,17,76.5,4,32,17,15,49,68,107,0
10273,25,17,11,9,5,11,31,35.5,20,11,0,11,2,27,5,0
10274,0,0,0,0,0,0,0,0.0,0,0,0,0,0,0,4,0
10275,6,3,2,4,0,0,3,0.0,3,1,0,1,3,9,15,0
10276,0,0,0,0,0,0,0,0.0,0,2,1,1,1,1,3,0
10277,32,21,21,11,0,21,25,84.0,4,32,22,10,40,72,121,0
10278,58,39,26,27,5,31,54,57.4,23,31,8,23,16,74,33,1
10279,51,37,26,20,5,22,36,61.1,14,35,8,27,30,81,83,2
10280,4,3,2,2,0,2,6,33.3,4,8,7,1,5,9,19,0
10281,4,1,3,1,0,2,6,33.3,4,4,3,1,4,8,12,0
10282,3,1,1,1,1,3,3,100.0,0,1,0,1,1,4,0,0
10283,5,3,2,3,0,4,5,80.0,1,6,2,4,1,6,2,0
10284,29,22,16,13,0,16,28,57.1,12,9,2,7,29,58,25,0
10285,152,97,73,68,11,90,159,56.6,69,78,28,50,64,216,100,1
10286,17,10,12,4,1,11,19,57.9,8,24,17,7,34,51,116,1
10287,31,15,16,13,2,12,27,44.4,15,13,1,12,4,35,2,1
10288,7,2,3,3,1,3,6,50.0,3,4,1,3,3,10,2,0
10289,6,5,3,3,0,6,9,66.7,3,2,0,2,2,8,1,0
10290,16,11,11,5,0,9,14,64.3,5,21,13,8,11,27,47,0
10291,35,23,14,14,7,17,43,39.5,26,25,3,22,12,47,11,0
10292,1,1,0,1,0,1,1,100.0,0,1,0,1,0,1,0,0
10293,0,0,0,0,0,0,2,0.0,2,0,0,0,2,2,21,5
10294,53,32,21,29,3,26,55,47.3,29,52,14,38,24,77,43,0
10295,13,7,3,8,2,5,11,45.5,6,7,0,7,4,17,8,0
10296,19,9,7,11,1,8,23,34.8,15,9,2,7,4,23,3,0
10297,37,23,26,10,1,19,45,42.2,26,23,4,19,17,54,48,0
10298,3,2,1,2,0,0,2,0.0,2,4,1,3,6,9,7,0
10299,3,2,1,2,0,1,2,50.0,1,0,0,0,2,5,2,0
10300,0,0,0,0,0,0,0,0.0,0,0,0,0,0,0,0,0
10301,12,11,4,5,3,5,8,62.5,3,14,4,10,1,13,13,0
10302,26,16,6,14,6,7,26,26.9,19,25,2,23,10,36,10,0
10303,2,0,0,1,1,1,5,20.0,4,6,1,5,0,2,7,0
10304,1,1,0,1,0,0,2,0.0,2,1,0,1,0,1,0,0
10305,51,34,15,32,4,21,57,36.8,36,29,10,19,18,69,52,0
10306,1,1,0,1,0,0,1,0.0,1,0,0,0,0,1,2,0
10307,0,0,0,0,0,0,0,0.0,0,0,0,0,0,0,3,0
10308,18,13,11,7,0,8,14,57.1,6,42,33,9,15,33,156,1
10309,35,20,24,10,1,21,31,67.7,10,21,11,10,22,57,76,0
10310,41,25,23,15,3,25,46,54.3,21,41,24,17,37,78,141,0
10311,27,18,11,14,2,15,33,45.5,18,23,8,15,14,41,31,0
10312,16,10,2,11,3,7,16,43.8,9,22,2,20,13,29,10,0
10313,13,7,6,4,3,10,15,66.7,5,18,1,17,2,15,20,0
10314,1,1,0,1,0,0,0,0.0,0,1,1,0,3,4,1,0
10315,22,15,4,14,4,6,12,50.0,6,10,5,5,8,30,19,0
10316,26,16,14,10,2,13,22,59.1,9,17,12,5,28,54,77,1
10317,48,31,24,20,4,23,34,67.6,11,38,18,20,35,83,91,1
10318,57,35,30,24,3,41,78,52.6,37,32,4,28,20,77,36,0
10319,46,32,17,25,4,22,41,53.7,19,19,0,19,18,64,12,1
10320,20,14,7,6,7,8,23,34.8,15,22,1,21,10,30,10,0
10321,9,7,5,3,1,2,4,50.0,2,1,0,1,3,12,10,0
10322,2,1,0,2,0,0,2,0.0,2,0,0,0,1,3,2,0
10323,25,19,17,7,1,12,15,80.0,3,34,20,14,24,49,91,0
10324,15,10,7,8,0,10,13,76.9,3,17,13,4,20,35,44,2
10325,17,9,10,6,1,10,16,62.5,6,19,10,9,19,36,44,0
10326,28,18,8,14,6,11,20,55.0,9,10,2,8,11,39,9,0
10327,26,18,8,12,6,11,27,40.7,16,22,1,21,14,40,10,0
10328,0,0,0,0,0,0,0,0.0,0,0,0,0,0,0,1,2
10329,9,3,4,4,1,5,12,41.7,7,10,2,8,6,15,20,0
10330,26,22,15,10,1,14,25,56.0,11,34,26,8,31,57,121,0
10331,21,11,17,3,1,13,20,65.0,7,10,7,3,11,32,48,1
10332,16,15,11,5,0,5,17,29.4,12,8,1,7,11,27,5,1
10333,0,0,0,0,0,0,0,0.0,0,2,0,2,0,0,3,0
10334,23,15,10,11,2,13,24,54.2,11,14,3,11,23,46,9,0
10335,8,5,3,2,3,2,6,33.3,4,7,0,7,5,13,6,0
10336,9,4,4,3,2,3,9,33.3,6,5,0,5,3,12,0,0
10337,30,21,15,10,5,17,37,45.9,20,16,1,15,11,41,18,0
10338,2,1,0,1,1,1,4,25.0,3,0,0,0,0,2,1,0
10339,28,16,11,15,2,14,27,51.9,13,17,5,12,25,53,58,0
10340,19,9,8,8,3,7,12,58.3,5,13,1,12,7,26,14,0
10341,6,3,4,2,0,4,11,36.4,7,1,1,0,2,8,2,0
10342,31,16,13,17,1,9,31,29.0,22,12,2,10,23,54,24,1
10343,2,1,2,0,0,2,3,66.7,1,0,0,0,0,2,22,1
10344,12,10,7,3,2,5,12,41.7,7,11,4,7,7,19,14,0
10345,21,12,11,9,1,13,29,44.8,16,15,5,10,12,33,14,1
10346,5,3,2,3,0,0,9,0.0,9,2,0,2,4,9,5,0
10347,70,42,18,39,13,19,41,46.3,22,43,8,35,38,108,50,0
10348,7,6,1,4,2,3,11,27.3,8,13,4,9,3,10,36,0
10349,0,0,0,0,0,0,0,0.0,0,2,0,2,0,0,0,0
10350,4,4,2,1,1,2,5,40.0,3,1,0,1,0,4,0,0
10351,0,0,0,0,0,0,1,0.0,1,0,0,0,0,0,2,0
10352,5,3,0,3,2,3,4,75.0,1,6,0,6,5,10,12,0
10353,32,21,18,12,2,13,26,50.0,13,21,13,8,25,57,71,2
10354,54,34,24,24,6,23,41,56.1,18,21,5,16,28,82,35,1
10355,60,37,35,18,7,34,56,60.7,22,34,6,28,36,96,37,0
10356,24,15,8,14,2,14,35,40.0,21,12,1,11,6,30,3,0
10357,2,1,1,1,0,1,2,50.0,1,1,0,1,0,2,0,0
10358,15,9,10,2,3,5,14,35.7,9,4,1,3,5,20,6,0
10359,9,5,4,5,0,1,6,16.7,5,5,1,4,8,17,5,0
10360,4,3,0,1,3,3,5,60.0,2,1,0,1,2,6,3,0
10361,4,2,2,2,0,2,6,33.3,4,2,1,1,1,5,5,0
10362,2,2,2,0,0,2,4,50.0,2,0,0,0,1,3,27,5
10363,4,2,0,3,1,2,4,50.0,2,0,0,0,0,4,0,0
10364,2,0,1,1,0,1,2,50.0,1,0,0,0,0,2,1,0
10365,0,0,0,0,0,0,0,0.0,0,0,0,0,1,1,1,0
10366,6,4,2,4,0,4,10,40.0,6,7,0,7,10,16,7,0
10367,9,6,1,5,3,5,8,62.5,3,5,1,4,0,9,5,0
10368,1,1,0,1,0,1,3,33.3,2,4,0,4,0,1,1,0
10369,64,43,27,26,11,36,74,48.6,38,41,6,35,42,106,41,0
10370,41,22,14,23,4,20,43,46.5,23,20,1,19,5,46,14,0
10371,39,23,29,9,1,18,20,90.0,2,29,15,14,44,83,76,2
10372,36,18,13,15,8,15,31,48.4,16,33,3,30,18,54,23,0
10373,1,0,0,1,0,1,3,33.3,2,3,2,1,2,3,5,0
10374,9,7,7,2,0,5,8,62.5,3,6,4,2,11,20,24,1
10375,16,10,10,5,1,8,14,57.1,6,10,5,5,6,22,16,0
10376,3,2,2,1,0,0,0,0.0,0,1,1,0,2,5,2,1
10377,5,3,1,4,0,3,8,37.5,5,8,2,6,0,5,2,0
10378,3,3,2,1,0,1,2,50.0,1,0,0,0,1,4,0,0
10379,11,8,3,5,3,6,22,27.3,16,10,0,10,4,15,17,0
10380,31,19,23,7,1,12,24,50.0,12,31,19,12,32,63,100,0
10381,72,42,26,37,9,22,54,40.7,32,26,5,21,29,101,17,0
10382,2,2,0,2,0,2,3,66.7,1,3,0,3,0,2,1,0
10383,5,5,2,2,1,3,4,75.0,1,0,0,0,0,5,2,0
10384,0,0,0,0,0,0,0,0.0,0,0,0,0,0,0,0,0
10385,27,14,8,11,8,14,40,35.0,26,33,3,30,15,42,11,0
10386,29,17,10,19,0,18,25,72.0,7,24,13,11,32,61,67,0
10387,89,61,67,18,4,62,83,74.7,21,62,36,26,77,166,204,3
10388,2,2,0,1,1,1,1,100.0,0,3,0,3,2,4,10,0
10389,8,6,3,2,3,3,15,20.0,12,2,0,2,3,11,3,0
10390,56,38,27,23,6,21,72,29.2,51,28,7,21,30,86,32,1
10391,57,30,20,31,6,24,58,41.4,34,31,7,24,11,68,25,0
10392,37,25,10,21,6,11,22,50.0,11,20,6,14,27,64,36,0
10393,33,23,15,9,9,16,31,51.6,15,23,1,22,4,37,21,0
10394,48,29,17,23,8,27,50,54.0,23,20,1,19,20,68,4,1
10395,0,0,0,0,0,0,4,0.0,4,0,0,0,0,0,8,0
10396,26,18,7,15,4,10,21,47.6,11,22,5,17,10,36,23,0
10397,82,48,43,35,4,44,100,44.0,56,43,8,35,51,133,49,1
10398,39,30,26,11,2,16,33,48.5,17,31,14,17,23,62,71,1
10399,3,2,1,1,1,1,5,20.0,4,6,2,4,2,5,1,0
10400,4,3,2,1,1,2,9,22.2,7,3,1,2,6,10,2,0
10401,7,5,5,1,1,5,7,71.4,2,5,2,3,10,17,20,0
10402,11,9,4,4,3,7,11,63.6,4,8,3,5,4,15,5,0
10403,49,34,18,23,8,18,47,38.3,29,33,8,25,30,79,23,0
10404,35,18,23,10,2,17,33,51.5,16,14,7,7,21,56,64,0
10405,0,0,0,0,0,0,2,0.0,2,0,0,0,0,0,13,1
10406,0,0,0,0,0,0,1,0.0,1,0,0,0,1,1,0,0
10407,58,36,31,24,3,29,42,69.0,13,56,35,21,59,117,133,2
10408,102,63,30,59,13,32,67,47.8,35,52,9,43,34,136,39,0
10409,38,26,20,12,6,18,25,72.0,7,15,4,11,27,65,42,0
10410,7,2,6,1,0,3,6,50.0,3,14,13,1,14,21,33,0
10411,12,7,4,7,1,5,9,55.6,4,12,4,8,4,16,5,0
10412,35,18,26,8,1,27,39,69.2,12,19,12,7,22,57,128,0
10413,4,0,0,2,2,1,6,16.7,5,1,0,1,4,8,7,0
10414,12,6,8,4,0,9,12,75.0,3,12,4,8,4,16,11,0
10415,30,20,18,8,4,17,23,73.9,6,16,5,11,12,42,45,0
10416,8,5,3,5,0,3,10,30.0,7,6,0,6,3,11,4,0
10417,6,6,4,2,0,3,4,75.0,1,2,1,1,1,7,6,0
10418,42,32,21,18,3,13,34,38.2,21,29,8,21,29,71,48,0
10419,27,16,18,8,1,12,17,70.6,5,27,13,14,35,62,93,0
10420,0,0,0,0,0,0,0,0.0,0,1,1,0,0,0,1,1
10421,10,6,6,4,0,2,10,20.0,8,12,2,10,5,15,1,2
10422,22,16,9,11,2,9,18,50.0,9,23,2,21,11,33,17,0
10423,1,0,0,1,0,0,0,0.0,0,1,0,1,1,2,0,0
10424,1,1,1,0,0,0,1,0.0,1,3,0,3,0,1,1,0
10425,44,30,15,22,7,23,51,45.1,28,23,3,20,22,66,23,0
10426,0,0,0,0,0,0,0,0.0,0,0,0,0,0,0,2,0
10427,0,0,0,0,0,0,2,0.0,2,0,0,0,0,0,16,2
10428,22,18,4,11,7,7,15,46.7,8,12,2,10,6,28,22,0
10429,10,4,1,6,3,5,23,21.7,18,9,0,9,4,14,3,1
10430,61,38,26,31,4,32,59,54.2,27,29,8,21,25,86,40,2
10431,4,2,1,3,0,1,4,25.0,3,3,0,3,1,5,1,0
10432,74,45,31,28,15,31,43,72.1,12,30,7,23,46,120,74,0
10433,8,4,1,4,3,5,13,38.5,8,6,0,6,5,13,3,0
10434,5,3,1,4,0,2,10,20.0,8,3,1,2,4,9,0,0
10435,18,16,9,7,2,9,23,39.1,14,16,3,13,6,24,11,0
10436,11,10,4,5,2,4,11,36.4,7,5,0,5,4,15,5,0
10437,18,11,7,10,1,11,26,42.3,15,19,3,16,14,32,22,0
10438,7,4,2,5,0,3,8,37.5,5,1,0,1,4,11,2,0
10439,7,4,3,3,1,6,10,60.0,4,0,0,0,4,11,2,1
10440,69,43,33,31,5,36,68,52.9,32,43,8,35,33,102,47,1
10441,1,1,0,1,0,0,1,0.0,1,2,2,0,5,6,14,0
10442,0,0,0,0,0,0,0,0.0,0,0,0,0,0,0,3,0
10443,0,0,0,0,0,0,3,0.0,3,0,0,0,0,0,0,0
10444,47,30,9,26,12,20,55,36.4,35,29,0,29,20,67,4,0
10445,13,8,4,5,4,7,12,58.3,5,5,0,5,5,18,3,0
10446,15,9,5,4,6,5,12,41.7,7,5,0,5,4,19,2,0
10447,24,20,14,6,4,15,23,65.2,8,20,14,6,21,45,62,0
10448,6,2,4,1,1,2,4,50.0,2,0,0,0,2,8,2,1
10449,2,1,1,1,0,1,1,100.0,0,3,1,2,1,3,1,0
10450,31,21,11,16,4,19,54,35.2,35,23,1,22,20,51,5,0
10451,7,4,3,3,1,5,9,55.6,4,8,1,7,3,10,3,0
10452,0,0,0,0,0,0,0,0.0,0,0,0,0,0,0,0,0
10453,0,0,0,0,0,0,0,0.0,0,0,0,0,2,2,1,0
10454,48,30,34,14,0,23,46,50.0,23,31,19,12,73,121,143,0
10455,2,2,1,0,1,1,1,100.0,0,0,0,0,0,2,0,0
10456,4,4,3,1,0,2,4,50.0,2,5,0,5,2,6,2,0
10457,45,37,31,11,3,20,37,54.1,17,31,16,15,47,92,112,1
10458,4,3,3,1,0,1,3,33.3,2,0,0,0,2,6,12,1
10459,16,11,6,6,4,5,13,38.5,8,7,0,7,5,21,8,0
10460,15,9,11,4,0,7,20,35.0,13,12,8,4,35,50,97,0
10461,36,27,18,18,0,22,33,66.7,11,16,12,4,6,42,52,0
10462,37,23,29,7,1,32,46,69.6,14,49,33,16,33,70,113,1
10463,17,13,4,6,7,6,30,20.0,24,17,0,17,6,23,1,0
10464,4,2,1,2,1,3,7,42.9,4,3,0,3,6,10,10,0
10465,1,1,0,1,0,0,0,0.0,0,0,0,0,0,1,1,0
10466,46,22,30,11,5,23,32,71.9,9,28,10,18,26,72,90,1
10467,26,11,8,17,1,8,30,26.7,22,20,4,16,23,49,10,1
10468,11,6,5,4,2,5,15,33.3,10,6,0,6,5,16,1,0
10469,23,14,6,14,3,5,25,20.0,20,21,3,18,5,28,4,0
10470,12,8,7,3,2,6,11,54.5,5,7,5,2,7,19,30,0
10471,16,9,13,3,0,9,12,75.0,3,20,16,4,23,39,98,2
10472,1,1,1,0,0,1,1,100.0,0,1,0,1,0,1,9,2
10473,6,4,4,0,2,4,5,80.0,1,2,0,2,5,11,3,0
10474,14,6,9,5,0,4,6,66.7,2,28,26,2,29,43,83,0
10475,0,0,0,0,0,0,0,0.0,0,0,0,0,0,0,0,0
10476,0,0,0,0,0,0,0,0.0,0,0,0,0,0,0,0,0
10477,13,9,7,5,1,7,11,63.6,4,3,1,2,4,17,13,0
10478,6,6,2,2,2,3,9,33.3,6,6,0,6,0,6,1,0
10479,24,12,17,6,1,11,18,61.1,7,8,2,6,13,37,30,0
10480,16,11,4,10,2,5,17,29.4,12,12,4,8,18,34,14,1
10481,16,10,5,7,4,4,11,36.4,7,10,0,10,6,22,3,0
10482,0,0,0,0,0,0,0,0.0,0,0,0,0,0,0,0,0
10483,21,14,8,11,2,10,28,35.7,18,16,1,15,5,26,15,1
10484,28,21,16,10,2,14,25,56.0,11,25,9,16,17,45,51,0
10485,18,12,9,8,1,4,21,19.0,17,9,1,8,10,28,8,0
10486,9,4,6,3,0,5,7,71.4,2,6,0,6,1,10,4,0
10487,68,42,31,33,4,32,58,55.2,26,36,10,26,35,103,24,0
10488,43,28,21,18,4,21,48,43.8,27,27,8,19,23,66,24,2
10489,1,1,1,0,0,1,2,50.0,1,0,0,0,2,3,3,0
10490,0,0,0,0,0,0,0,0.0,0,0,0,0,1,1,17,3
10491,44,20,28,16,0,27,40,67.5,13,43,28,15,42,86,159,2
10492,0,0,0,0,0,0,0,0.0,0,0,0,0,0,0,0,0
10493,15,9,10,2,3,8,20,40.0,12,20,5,15,12,27,21,0
10494,1,0,0,1,0,0,1,0.0,1,0,0,0,0,1,1,0
10495,0,0,0,0,0,0,0,0.0,0,0,0,0,0,0,0,0
10496,0,0,0,0,0,0,0,0.0,0,0,0,0,0,0,0,0
10497,56,34,34,22,0,28,42,66.7,14,51,38,13,51,107,112,3
10498,8,7,0,6,2,2,4,50.0,2,5,0,5,4,12,6,0
10499,2,2,0,2,0,1,3,33.3,2,0,0,0,1,3,0,0
10500,16,9,11,5,0,8,19,42.1,11,16,7,9,13,29,35,0
10501,0,0,0,0,0,0,0,0.0,0,0,0,0,0,0,0,0
10502,0,0,0,0,0,0,1,0.0,1,0,0,0,0,0,0,0
10503,1,1,0,0,1,0,1,0.0,1,0,0,0,0,1,0,0
10504,54,33,15,31,8,23,49,46.9,26,44,5,39,22,76,78,0
10505,17,12,7,7,3,9,23,39.1,14,16,2,14,14,31,15,0
10506,34,17,13,19,2,18,27,66.7,9,13,3,10,24,58,18,1
10507,13,8,4,6,3,6,7,85.7,1,8,3,5,2,15,12,1
10508,34,18,7,19,8,17,42,40.5,25,29,2,27,10,44,9,0
10509,2,1,0,1,1,2,2,100.0,0,0,0,0,0,2,1,0
10510,38,24,17,18,3,13,38,34.2,25,22,2,20,29,67,31,1
10511,22,13,9,13,0,15,30,50.0,15,13,3,10,15,37,11,0
10512,7,6,3,2,2,5,10,50.0,5,11,3,8,8,15,14,0
10513,19,6,9,4,6,10,21,47.6,11,17,1,16,4,23,8,0
10514,35,19,11,17,7,11,24,45.8,13,27,2,25,29,64,8,0
10515,22,15,11,6,5,14,27,51.9,13,18,1,17,6,28,8,0
10516,8,4,4,1,3,2,6,33.3,4,4,0,4,4,12,5,0
10517,54,34,20,27,7,28,51,54.9,23,36,9,27,39,93,33,0
10518,10,6,1,6,3,1,10,10.0,9,18,2,16,4,14,13,0
10519,1,0,0,0,1,1,3,33.3,2,5,1,4,5,6,1,0
10520,27,16,9,12,6,12,28,42.9,16,6,1,5,9,36,10,0
10521,15,10,11,4,0,10,11,90.9,1,2,1,1,12,27,15,0
10522,6,4,5,1,0,4,5,80.0,1,2,0,2,5,11,19,0
10523,4,3,3,1,0,3,3,100.0,0,3,0,3,2,6,11,0
10524,0,0,0,0,0,0,1,0.0,1,0,0,0,0,0,1,0
10525,40,25,19,18,3,22,35,62.9,13,38,17,21,29,69,115,0
10526,71,40,40,18,13,53,79,67.1,26,36,7,29,36,107,79,0
10527,1,1,1,0,0,1,2,50.0,1,0,0,0,0,1,6,0
10528,21,14,10,8,3,8,30,26.7,22,17,2,15,15,36,19,2
10529,50,34,28,17,5,28,70,40.0,42,52,4,48,36,86,52,0
10530,3,3,0,1,2,0,2,0.0,2,4,0,4,3,6,4,0
10531,1,1,1,0,0,1,2,50.0,1,0,0,0,0,1,18,3
10532,37,26,14,18,5,17,46,37.0,29,20,5,15,19,56,17,1
10533,20,13,3,11,6,8,16,50.0,8,7,2,5,5,25,23,1
10534,3,1,1,1,1,1,2,50.0,1,7,0,7,2,5,1,0
10535,20,11,4,11,5,7,19,36.8,12,12,1,11,6,26,3,0
10536,3,2,1,2,0,1,2,50.0,1,1,0,1,0,3,4,0
10537,43,32,27,8,8,23,58,39.7,35,22,6,16,14,57,41,0
10538,2,2,2,0,0,1,3,33.3,2,4,0,4,0,2,1,0
10539,0,0,0,0,0,0,0,0.0,0,0,0,0,0,0,0,0
10540,32,18,18,12,2,23,65,35.4,42,30,4,26,36,68,69,2
10541,5,5,3,1,1,3,10,30.0,7,1,0,1,0,5,0,0
10542,23,8,11,10,2,14,30,46.7,16,19,8,11,10,33,21,0
10543,0,0,0,0,0,0,0,0.0,0,0,0,0,0,0,0,0
10544,1,1,0,1,0,1,1,100.0,0,0,0,0,1,2,0,0
10545,27,16,12,8,7,11,23,47.8,12,7,1,6,14,41,10,0
10546,47,27,20,23,4,25,59,42.4,34,22,2,20,28,75,11,0
10547,3,2,1,1,1,0,6,0.0,6,2,0,2,5,8,3,0
10548,5,3,1,3,1,2,7,28.6,5,8,0,8,1,6,2,0
10549,14,7,2,6,6,6,16,37.5,10,21,4,17,2,16,24,0
10550,5,4,2,3,0,3,5,60.0,2,2,1,1,0,5,0,0
10551,6,5,0,5,1,1,6,16.7,5,5,0,5,0,6,9,0
10552,4,4,2,1,1,0,5,0.0,5,2,0,2,1,5,2,0
10553,8,5,2,2,4,3,6,50.0,3,4,0,4,1,9,5,0
10554,11,5,4,5,2,3,8,37.5,5,3,0,3,1,12,5,0
10555,0,0,0,0,0,0,0,0.0,0,0,0,0,0,0,8,1
10556,0,0,0,0,0,0,0,0.0,0,0,0,0,0,0,6,0
10557,14,7,3,10,1,6,15,40.0,9,9,2,7,4,18,12,0
10558,34,23,16,11,7,18,42,42.9,24,13,1,12,11,45,10,0
10559,1,0,0,1,0,1,1,100.0,0,1,1,0,0,1,8,0
10560,54,35,36,14,4,35,51,68.6,16,18,3,15,22,76,45,0
10561,25,17,9,14,2,14,37,37.8,23,20,8,12,10,35,31,0
10562,68,44,32,31,5,27,85,31.8,58,38,9,29,30,98,39,0
10563,14,6,7,4,3,7,24,29.2,17,5,0,5,7,21,7,0
10564,21,12,12,8,1,6,14,42.9,8,19,9,10,12,33,17,1
10565,35,21,25,7,3,17,25,68.0,8,39,16,23,33,68,91,0
10566,19,10,5,13,1,6,15,40.0,9,16,2,14,14,33,7,0
10567,32,19,18,12,2,21,46,45.7,25,38,26,12,34,66,131,3
10568,51,28,22,24,5,31,57,54.4,26,43,17,26,40,91,89,0
10569,0,0,0,0,0,0,1,0.0,1,0,0,0,0,0,1,0
10570,7,5,5,2,0,1,9,11.1,8,7,0,7,2,9,4,0
10571,1,1,0,1,0,0,6,0.0,6,1,0,1,2,3,4,0
10572,21,12,7,14,0,8,24,33.3,16,21,7,14,20,41,23,0
10573,0,0,0,0,0,0,1,0.0,1,0,0,0,1,1,7,1
10574,12,7,2,6,4,6,11,54.5,5,18,2,16,2,14,5,0
10575,14,11,7,7,0,7,10,70.0,3,4,1,3,6,20,15,0
10576,11,8,6,5,0,4,13,30.8,9,9,5,4,8,19,10,1
10577,4,2,2,1,1,1,6,16.7,5,5,2,3,1,5,11,0
10578,18,13,10,8,0,4,6,66.7,2,9,6,3,15,33,32,1
